AAAACAGACAAGTGACGCT -> AAACAGACAAGTGACGCTA
AAAACGAAAATGGTCACTC -> AAACGAAAATGGTCACTCT
AAAAGTGCCGAGATGCTAT -> AAAGTGCCGAGATGCTATA
AAAATAAAGGGCCTGGTCC -> AAATAAAGGGCCTGGTCCG
AAAATACAGAGTAAGACAG -> AAATACAGAGTAAGACAGG
AAAATCTCCGAGGCATCGG -> AAATCTCCGAGGCATCGGA
AAAATGGTCACTCTAACAT -> AAATGGTCACTCTAACATT
AAACAGACAAGTGACGCTA -> AACAGACAAGTGACGCTAT
AAACAGGGTAGCGCTTCGT -> AACAGGGTAGCGCTTCGTC
AAACCGCATGCGGTCGTAT -> AACCGCATGCGGTCGTATC
AAACGAAAATGGTCACTCT -> AACGAAAATGGTCACTCTA
AAACGGAAGTGATTGGTGT -> AACGGAAGTGATTGGTGTC
AAACGGGCGCCCTGTCGTG -> AACGGGCGCCCTGTCGTGG
AAACGTAACTGAGCTTTTA -> AACGTAACTGAGCTTTTAG
AAACTCCTCTTTTGGGTCG -> AACTCCTCTTTTGGGTCGT
AAAGAAGATTTGCCGGTCT -> AAGAAGATTTGCCGGTCTA
AAAGATTAGAACCCTTCTG -> AAGATTAGAACCCTTCTGC
AAAGCAACACCTGCCTAGG -> AAGCAACACCTGCCTAGGA
AAAGCTTCCTCTGAAAAGT -> AAGCTTCCTCTGAAAAGTG
AAAGGGCCTGGTCCGTTCC -> AAGGGCCTGGTCCGTTCCG
AAAGTGCCGAGATGCTATA -> AAGTGCCGAGATGCTATAG
AAATAAAGGGCCTGGTCCG -> AATAAAGGGCCTGGTCCGT
AAATACAGAGTAAGACAGG -> AATACAGAGTAAGACAGGC
AAATCAAAATACAGAGTAA -> AATCAAAATACAGAGTAAG
AAATCTCCGAGGCATCGGA -> AATCTCCGAGGCATCGGAG
AAATGACTAGGAGAGAGCT -> AATGACTAGGAGAGAGCTG
AAATGAGTCTCGAACCCAC -> AATGAGTCTCGAACCCACG
AAATGGTCACTCTAACATT -> AATGGTCACTCTAACATTG
AAATGTGATCCGTTAGAAC -> AATGTGATCCGTTAGAACG
AAATTGACAGGAGGCGCCC -> AATTGACAGGAGGCGCCCG
AAATTTAATGGAATGCCTC -> AATTTAATGGAATGCCTCA
AACAAACCGCATGCGGTCG -> ACAAACCGCATGCGGTCGT
AACAAGTCCGGATATGGAG -> ACAAGTCCGGATATGGAGA
AACAAGTTGACGTACGCAT -> ACAAGTTGACGTACGCATC
AACACCTGCCTAGGACCGG -> ACACCTGCCTAGGACCGGT
AACACCTGCCTAGGCCTGC -> ACACCTGCCTAGGCCTGCT
AACACCTGCCTAGGGCCAT -> ACACCTGCCTAGGGCCATG
AACACCTGCCTAGGTAATT -> ACACCTGCCTAGGTAATTT
AACACGCCTATTGTCTGAT -> ACACGCCTATTGTCTGATG
AACAGACAAGTGACGCTAT -> ACAGACAAGTGACGCTATC
AACAGGGTAGCGCTTCGTC -> ACAGGGTAGCGCTTCGTCT
AACATTGGCCCTGTGACCA -> ACATTGGCCCTGTGACCAC
AACCACAGCTCCCTTGACT -> ACCACAGCTCCCTTGACTA
AACCACGCGCGTATCGTGT -> ACCACGCGCGTATCGTGTC
AACCATGACATTCGGCTCC -> ACCATGACATTCGGCTCCT
AACCCACGCGGCCGACTCT -> ACCCACGCGGCCGACTCTG
AACCCTTCAGAAACGGAAG -> ACCCTTCAGAAACGGAAGT
AACCCTTCTGCGGCTAAAC -> ACCCTTCTGCGGCTAAACG
AACCGCATGCGGTCGTATC -> ACCGCATGCGGTCGTATCG
AACCTCGTCCCCAAGCACT -> ACCTCGTCCCCAAGCACTC
AACGAAAATGGTCACTCTA -> ACGAAAATGGTCACTCTAA
AACGCCATTACGACGGTAA -> ACGCCATTACGACGGTAAA
AACGGAAGTGATTGGTGTC -> ACGGAAGTGATTGGTGTCG
AACGGAGCATTATTAGTAG -> ACGGAGCATTATTAGTAGA
AACGGGATCGGATCGGGAT -> ACGGGATCGGATCGGGATC
AACGGGCGCCCTGTCGTGG -> ACGGGCGCCCTGTCGTGGT
AACGTAACTGAGCTTTTAG -> ACGTAACTGAGCTTTTAGT
AACGTATGCCCGGGCTATT -> ACGTATGCCCGGGCTATTT
AACGTTCCTAACTAATTGC -> ACGTTCCTAACTAATTGCA
AACTAATTGCAAGCAACAC -> ACTAATTGCAAGCAACACC
AACTAGGGGTTTGCAAGCA -> ACTAGGGGTTTGCAAGCAA
AACTCCTCTTTTGGGTCGT -> ACTCCTCTTTTGGGTCGTA
AACTCGTCCTTGGCAGCCC -> ACTCGTCCTTGGCAGCCCG
AACTCGTGCCTTCCGGCAG -> ACTCGTGCCTTCCGGCAGC
AACTGACCTCACCCTAGCC -> ACTGACCTCACCCTAGCCC
AACTGAGCTTTTAGTCAGG -> ACTGAGCTTTTAGTCAGGG
AACTGGTGCATTTGTTTAG -> ACTGGTGCATTTGTTTAGT
AACTTTTTCTCCAGCCCTG -> ACTTTTTCTCCAGCCCTGC
AAGAAGATTTGCCGGTCTA -> AGAAGATTTGCCGGTCTAA
AAGACAGGCTTAATGCGAC -> AGACAGGCTTAATGCGACT
AAGACTAAGCGCTCCAAAC -> AGACTAAGCGCTCCAAACT
AAGACTTGAAGCCAACCAC -> AGACTTGAAGCCAACCACA
AAGATTAGAACCCTTCTGC -> AGATTAGAACCCTTCTGCG
AAGATTTGCCGGTCTAATC -> AGATTTGCCGGTCTAATCA
AAGCAAATTTAATGGAATG -> AGCAAATTTAATGGAATGC
AAGCAACACCTGCCTAGGA -> AGCAACACCTGCCTAGGAC
AAGCAACACCTGCCTAGGC -> AGCAACACCTGCCTAGGCC
AAGCAACACCTGCCTAGGG -> AGCAACACCTGCCTAGGGC
AAGCAACACCTGCCTAGGT -> AGCAACACCTGCCTAGGTA
AAGCACTCCCGGCTTGAAC -> AGCACTCCCGGCTTGAACT
AAGCCAACCACAGCTCCCT -> AGCCAACCACAGCTCCCTT
AAGCCATTATTCCCCGATC -> AGCCATTATTCCCCGATCG
AAGCCCGTTATCTGCTCGC -> AGCCCGTTATCTGCTCGCA
AAGCCCTGTTACTACTCGG -> AGCCCTGTTACTACTCGGC
AAGCGCGCCACCCTAAAAT -> AGCGCGCCACCCTAAAATA
AAGCGCTCCAAACTCCTCT -> AGCGCTCCAAACTCCTCTT
AAGCTCCACACACTTTGTA -> AGCTCCACACACTTTGTAC
AAGCTTCCTCTGAAAAGTG -> AGCTTCCTCTGAAAAGTGC
AAGGACGATCCAGACTGTC -> AGGACGATCCAGACTGTCG
AAGGACGATCCCGTGGAGG -> AGGACGATCCCGTGGAGGG
AAGGACGATCCCGTTAATC -> AGGACGATCCCGTTAATCC
AAGGACGATCCGCTAAACG -> AGGACGATCCGCTAAACGG
AAGGCGTTGTGTAGGACAA -> AGGCGTTGTGTAGGACAAG
AAGGGACGTGAAGACTAAG -> AGGGACGTGAAGACTAAGC
AAGGGCCTGGTCCGTTCCG -> AGGGCCTGGTCCGTTCCGG
AAGGGTCTCGGGCACCGAC -> AGGGTCTCGGGCACCGACT
AAGTAGATTAGCTCACGTG -> AGTAGATTAGCTCACGTGC
AAGTCCGGATATGGAGAGA -> AGTCCGGATATGGAGAGAA
AAGTGACGCTATCCACATC -> AGTGACGCTATCCACATCC
AAGTGATTGGTGTCGACCA -> AGTGATTGGTGTCGACCAA
AAGTGCCGAGATGCTATAG -> AGTGCCGAGATGCTATAGC
AAGTGGGGTCTAGCAGAAG -> AGTGGGGTCTAGCAGAAGC
AAGTTGACGTACGCATCAT -> AGTTGACGTACGCATCATA
AATAAAGGGCCTGGTCCGT -> ATAAAGGGCCTGGTCCGTT
AATACAGAGTAAGACAGGC -> ATACAGAGTAAGACAGGCT
AATCAAAATACAGAGTAAG -> ATCAAAATACAGAGTAAGA
AATCACACAATCCCGACAG -> ATCACACAATCCCGACAGG
AATCCACGGTTATTAACAA -> ATCCACGGTTATTAACAAG
AATCCCGACAGGTATTGGG -> ATCCCGACAGGTATTGGGA
AATCGCAGCGCACTAATGC -> ATCGCAGCGCACTAATGCC
AATCGTACTGTGTCTAACG -> ATCGTACTGTGTCTAACGG
AATCTCCGAGGCATCGGAG -> ATCTCCGAGGCATCGGAGG
AATCTTTTAGACAACCCTT -> ATCTTTTAGACAACCCTTC
AATGACTAGGAGAGAGCTG -> ATGACTAGGAGAGAGCTGG
AATGAGACAGAGAGGTGTA -> ATGAGACAGAGAGGTGTAC
AATGAGTCTCGAACCCACG -> ATGAGTCTCGAACCCACGC
AATGCCAACTGGTGCATTT -> ATGCCAACTGGTGCATTTG
AATGCCAAGTAGATTAGCT -> ATGCCAAGTAGATTAGCTC
AATGCCGCATGTCGAGGGC -> ATGCCGCATGTCGAGGGCT
AATGCCTCACAGTTAGAAC -> ATGCCTCACAGTTAGAACG
AATGCGACTTTTCCTATCG -> ATGCGACTTTTCCTATCGA
AATGGAATGCCTCACAGTT -> ATGGAATGCCTCACAGTTA
AATGGTCACTCTAACATTG -> ATGGTCACTCTAACATTGG
AATGGTGACGACTGCAGAC -> ATGGTGACGACTGCAGACG
AATGTGATCCGTTAGAACG -> ATGTGATCCGTTAGAACGG
AATTCTTCGCGGCGAACTC -> ATTCTTCGCGGCGAACTCG
AATTGACAGGAGGCGCCCG -> ATTGACAGGAGGCGCCCGG
AATTGCAAGCAACACCTGC -> ATTGCAAGCAACACCTGCC
AATTGGACTTATATTCTTA -> ATTGGACTTATATTCTTAA
AATTTAATGGAATGCCTCA -> ATTTAATGGAATGCCTCAC
AATTTCTCTTATGGGACGG -> ATTTCTCTTATGGGACGGT
AATTTTTGTGGACTGTGCA -> ATTTTTGTGGACTGTGCAA
ACAAACCGCATGCGGTCGT -> CAAACCGCATGCGGTCGTA
ACAACCCTTCAGAAACGGA -> CAACCCTTCAGAAACGGAA
ACAACGTATGCCCGGGCTA -> CAACGTATGCCCGGGCTAT
ACAAGCTCCACACACTTTG -> CAAGCTCCACACACTTTGT
ACAAGTCCGGATATGGAGA -> CAAGTCCGGATATGGAGAG
ACAAGTGACGCTATCCACA -> CAAGTGACGCTATCCACAT
ACAAGTTGACGTACGCATC -> CAAGTTGACGTACGCATCA
ACAATCCCGACAGGTATTG -> CAATCCCGACAGGTATTGG
ACAATTTCTCTTATGGGAC -> CAATTTCTCTTATGGGACG
ACACAATCCCGACAGGTAT -> CACAATCCCGACAGGTATT
ACACACTTTGTACCTTTTA -> CACACTTTGTACCTTTTAC
ACACATCGACTCCCGGCTC -> CACATCGACTCCCGGCTCT
ACACCTGCCTAGGACCGGT -> CACCTGCCTAGGACCGGTT
ACACCTGCCTAGGCCTGCT -> CACCTGCCTAGGCCTGCTG
ACACCTGCCTAGGGCCATG -> CACCTGCCTAGGGCCATGA
ACACCTGCCTAGGTAATTT -> CACCTGCCTAGGTAATTTT
ACACGCCTATTGTCTGATG -> CACGCCTATTGTCTGATGC
ACACTCCTATGACTGCACA -> CACTCCTATGACTGCACAA
ACACTTTGTACCTTTTACT -> CACTTTGTACCTTTTACTT
ACAGACAAGTGACGCTATC -> CAGACAAGTGACGCTATCC
ACAGAGACTGTGCAAGGAC -> CAGAGACTGTGCAAGGACG
ACAGAGAGGTGTACGCACT -> CAGAGAGGTGTACGCACTC
ACAGAGTAAGACAGGCTTA -> CAGAGTAAGACAGGCTTAA
ACAGATACCTCCCCTTTCA -> CAGATACCTCCCCTTTCAC
ACAGCTCCCTTGACTACTA -> CAGCTCCCTTGACTACTAT
ACAGGAGGCGCCCGGCTTT -> CAGGAGGCGCCCGGCTTTC
ACAGGCTTAATGCGACTTT -> CAGGCTTAATGCGACTTTT
ACAGGGTAGCGCTTCGTCT -> CAGGGTAGCGCTTCGTCTT
ACAGGTATTGGGATCATGT -> CAGGTATTGGGATCATGTA
ACAGTTAGAACGTTCCTAA -> CAGTTAGAACGTTCCTAAC
ACATCCGATTAAGACTTGA -> CATCCGATTAAGACTTGAA
ACATCGACTCCCGGCTCTC -> CATCGACTCCCGGCTCTCC
ACATGCGAAAGAAGATTTG -> CATGCGAAAGAAGATTTGC
ACATTCGGCTCCTGGCTGG -> CATTCGGCTCCTGGCTGGA
ACATTGGCCCTGTGACCAC -> CATTGGCCCTGTGACCACT
ACATTTACTCTTCCGGCCG -> CATTTACTCTTCCGGCCGT
ACCAACGCCATTACGACGG -> CCAACGCCATTACGACGGT
ACCACAGCTCCCTTGACTA -> CCACAGCTCCCTTGACTAC
ACCACGCGCGTATCGTGTC -> CCACGCGCGTATCGTGTCC
ACCACTTAGTTACACATCG -> CCACTTAGTTACACATCGA
ACCAGCGTACCGGTGCTGC -> CCAGCGTACCGGTGCTGCA
ACCATGACATTCGGCTCCT -> CCATGACATTCGGCTCCTG
ACCCACGCGGCCGACTCTG -> CCCACGCGGCCGACTCTGA
ACCCCGAAAATCTCCGAGG -> CCCCGAAAATCTCCGAGGC
ACCCTAAAATAAAGGGCCT -> CCCTAAAATAAAGGGCCTG
ACCCTAGCCCTTGCTTCGA -> CCCTAGCCCTTGCTTCGAA
ACCCTTCAGAAACGGAAGT -> CCCTTCAGAAACGGAAGTG
ACCCTTCTGCGGCTAAACG -> CCCTTCTGCGGCTAAACGT
ACCGACTTTCGGGTCATGC -> CCGACTTTCGGGTCATGCT
ACCGCATGCGGTCGTATCG -> CCGCATGCGGTCGTATCGA
ACCGGTGCTGCATGATGGG -> CCGGTGCTGCATGATGGGG
ACCGGTTTACGGACTGTGC -> CCGGTTTACGGACTGTGCA
ACCGTACGACCCCGAAAAT -> CCGTACGACCCCGAAAATC
ACCTCAATCGCAGCGCACT -> CCTCAATCGCAGCGCACTA
ACCTCACCCTAGCCCTTGC -> CCTCACCCTAGCCCTTGCT
ACCTCCCCTTTCACATGCG -> CCTCCCCTTTCACATGCGA
ACCTCGTCCCCAAGCACTC -> CCTCGTCCCCAAGCACTCC
ACCTGCCTAGGACCGGTTT -> CCTGCCTAGGACCGGTTTA
ACCTGCCTAGGCCTGCTGC -> CCTGCCTAGGCCTGCTGCG
ACCTGCCTAGGGCCATGAC -> CCTGCCTAGGGCCATGACA
ACCTGCCTAGGTAATTTTT -> CCTGCCTAGGTAATTTTTG
ACCTTCGGAACAAGTTGAC -> CCTTCGGAACAAGTTGACG
ACCTTTTACTTGTTCGCCG -> CCTTTTACTTGTTCGCCGT
ACGAAAATGGTCACTCTAA -> CGAAAATGGTCACTCTAAC
ACGAACTGACCTCACCCTA -> CGAACTGACCTCACCCTAG
ACGACCCCGAAAATCTCCG -> CGACCCCGAAAATCTCCGA
ACGACGGTAAATCAAAATA -> CGACGGTAAATCAAAATAC
ACGACTGCAGACGCGTCTC -> CGACTGCAGACGCGTCTCT
ACGAGTAAGCCCGTTATCT -> CGAGTAAGCCCGTTATCTG
ACGATCCAGACTGTCGATT -> CGATCCAGACTGTCGATTT
ACGATCCCGTGGAGGGCGG -> CGATCCCGTGGAGGGCGGC
ACGATCCCGTTAATCCACG -> CGATCCCGTTAATCCACGG
ACGATCCGCTAAACGGGCG -> CGATCCGCTAAACGGGCGC
ACGCACTCCGTGAAGCCAT -> CGCACTCCGTGAAGCCATT
ACGCATCATACACTCCTAT -> CGCATCATACACTCCTATG
ACGCCATTACGACGGTAAA -> CGCCATTACGACGGTAAAT
ACGCCTATTGTCTGATGCC -> CGCCTATTGTCTGATGCCG
ACGCCTCGGGGCCGGCACC -> CGCCTCGGGGCCGGCACCA
ACGCGCGTATCGTGTCCCC -> CGCGCGTATCGTGTCCCCG
ACGCGGCCGACTCTGAACC -> CGCGGCCGACTCTGAACCA
ACGCGTCTCTCGTAAAGCA -> CGCGTCTCTCGTAAAGCAA
ACGCTACATTTACTCTTCC -> CGCTACATTTACTCTTCCG
ACGCTATCCACATCCGATT -> CGCTATCCACATCCGATTA
ACGGAAGTGATTGGTGTCG -> CGGAAGTGATTGGTGTCGA
ACGGACTGTGCAAGGACGA -> CGGACTGTGCAAGGACGAT
ACGGAGCATTATTAGTAGA -> CGGAGCATTATTAGTAGAA
ACGGATGAGGGACTACGAA -> CGGATGAGGGACTACGAAC
ACGGATGGTTAATTCTTCG -> CGGATGGTTAATTCTTCGC
ACGGCATACCGTACGACCC -> CGGCATACCGTACGACCCC
ACGGGATCGGATCGGGATC -> CGGGATCGGATCGGGATCT
ACGGGCGCCCTGTCGTGGT -> CGGGCGCCCTGTCGTGGTG
ACGGTAAATCAAAATACAG -> CGGTAAATCAAAATACAGA
ACGGTACGGCATACCGTAC -> CGGTACGGCATACCGTACG
ACGGTTATTAACAAGTCCG -> CGGTTATTAACAAGTCCGG
ACGGTTCGGTCAAAGATTA -> CGGTTCGGTCAAAGATTAG
ACGTAACTGAGCTTTTAGT -> CGTAACTGAGCTTTTAGTC
ACGTACGCATCATACACTC -> CGTACGCATCATACACTCC
ACGTACTGTTGACAATTTC -> CGTACTGTTGACAATTTCT
ACGTATGCCCGGGCTATTT -> CGTATGCCCGGGCTATTTA
ACGTGAAGACTAAGCGCTC -> CGTGAAGACTAAGCGCTCC
ACGTGCTGCATGAACTCGT -> CGTGCTGCATGAACTCGTG
ACGTTCCTAACTAATTGCA -> CGTTCCTAACTAATTGCAA
ACTAAGCGCTCCAAACTCC -> CTAAGCGCTCCAAACTCCT
ACTAATGCCAACTGGTGCA -> CTAATGCCAACTGGTGCAT
ACTAATTGCAAGCAACACC -> CTAATTGCAAGCAACACCT
ACTACGAACTGACCTCACC -> CTACGAACTGACCTCACCC
ACTACTATATAAAGCTTCC -> CTACTATATAAAGCTTCCT
ACTACTCGGCGCTGAAGTG -> CTACTCGGCGCTGAAGTGG
ACTAGGAGAGAGCTGGGCG -> CTAGGAGAGAGCTGGGCGA
ACTAGGGGTTTGCAAGCAA -> CTAGGGGTTTGCAAGCAAA
ACTATATAAAGCTTCCTCT -> CTATATAAAGCTTCCTCTG
ACTATATATCCGAGGCAAG -> CTATATATCCGAGGCAAGG
ACTCCCGGCTCTCCAGGCG -> CTCCCGGCTCTCCAGGCGG
ACTCCCGGCTTGAACTTTT -> CTCCCGGCTTGAACTTTTT
ACTCCGTGAAGCCATTATT -> CTCCGTGAAGCCATTATTC
ACTCCTATGACTGCACAAC -> CTCCTATGACTGCACAACG
ACTCCTCTTTTGGGTCGTA -> CTCCTCTTTTGGGTCGTAG
ACTCGATTTTCTAATGCCA -> CTCGATTTTCTAATGCCAA
ACTCGGCGCTGAAGTGGGG -> CTCGGCGCTGAAGTGGGGT
ACTCGTCCTTGGCAGCCCG -> CTCGTCCTTGGCAGCCCGC
ACTCGTGCCTTCCGGCAGC -> CTCGTGCCTTCCGGCAGCC
ACTCTAACATTGGCCCTGT -> CTCTAACATTGGCCCTGTG
ACTCTGAACCATGACATTC -> CTCTGAACCATGACATTCG
ACTCTTCCGGCCGTAAGCA -> CTCTTCCGGCCGTAAGCAA
ACTGACCTCACCCTAGCCC -> CTGACCTCACCCTAGCCCT
ACTGAGCTTTTAGTCAGGG -> CTGAGCTTTTAGTCAGGGA
ACTGCACAACGTATGCCCG -> CTGCACAACGTATGCCCGG
ACTGCAGACGCGTCTCTCG -> CTGCAGACGCGTCTCTCGT
ACTGCGAAGGGACGTGAAG -> CTGCGAAGGGACGTGAAGA
ACTGGCTATCCTTTGCATG -> CTGGCTATCCTTTGCATGG
ACTGGTGCATTTGTTTAGT -> CTGGTGCATTTGTTTAGTA
ACTGTCGATTTCCTGCTAA -> CTGTCGATTTCCTGCTAAA
ACTGTGCAAGGACGATCCA -> CTGTGCAAGGACGATCCAG
ACTGTGCAAGGACGATCCC -> CTGTGCAAGGACGATCCCG,CTGTGCAAGGACGATCCCG
ACTGTGCAAGGACGATCCG -> CTGTGCAAGGACGATCCGC
ACTGTGTCTAACGGGATCG -> CTGTGTCTAACGGGATCGG
ACTGTTGACAATTTCTCTT -> CTGTTGACAATTTCTCTTA
ACTTAGTTACACATCGACT -> CTTAGTTACACATCGACTC
ACTTATATTCTTAACCACG -> CTTATATTCTTAACCACGC
ACTTGAAGCCAACCACAGC -> CTTGAAGCCAACCACAGCT
ACTTGTTCGCCGTGTTAAC -> CTTGTTCGCCGTGTTAACA
ACTTTACCTTCGGAACAAG -> CTTTACCTTCGGAACAAGT
ACTTTCCATTTAGATATGA -> CTTTCCATTTAGATATGAG
ACTTTCGGGTCATGCTCCG -> CTTTCGGGTCATGCTCCGC
ACTTTGTACCTTTTACTTG -> CTTTGTACCTTTTACTTGT
ACTTTTCCTATCGACGGAT -> CTTTTCCTATCGACGGATG
ACTTTTTCTCCAGCCCTGC -> CTTTTTCTCCAGCCCTGCC
AGAAACGGAAGTGATTGGT -> GAAACGGAAGTGATTGGTG
AGAAATGACTAGGAGAGAG -> GAAATGACTAGGAGAGAGC
AGAAATTGACAGGAGGCGC -> GAAATTGACAGGAGGCGCC
AGAACCCTTCTGCGGCTAA -> GAACCCTTCTGCGGCTAAA
AGAACGGAGCATTATTAGT -> GAACGGAGCATTATTAGTA
AGAACGTTCCTAACTAATT -> GAACGTTCCTAACTAATTG
AGAAGATTTGCCGGTCTAA -> GAAGATTTGCCGGTCTAAT
AGAAGCGCGCCACCCTAAA -> GAAGCGCGCCACCCTAAAA
AGAATTGGACTTATATTCT -> GAATTGGACTTATATTCTT
AGACAACCCTTCAGAAACG -> GACAACCCTTCAGAAACGG
AGACAAGTGACGCTATCCA -> GACAAGTGACGCTATCCAC
AGACAGAGAGGTGTACGCA -> GACAGAGAGGTGTACGCAC
AGACAGGCTTAATGCGACT -> GACAGGCTTAATGCGACTT
AGACGCGTCTCTCGTAAAG -> GACGCGTCTCTCGTAAAGC
AGACGGTACGGCATACCGT -> GACGGTACGGCATACCGTA
AGACTAAGCGCTCCAAACT -> GACTAAGCGCTCCAAACTC
AGACTGGCTATCCTTTGCA -> GACTGGCTATCCTTTGCAT
AGACTGTCGATTTCCTGCT -> GACTGTCGATTTCCTGCTA
AGACTGTGCAAGGACGATC -> GACTGTGCAAGGACGATCC
AGACTTGAAGCCAACCACA -> GACTTGAAGCCAACCACAG
AGAGAATTGGACTTATATT -> GAGAATTGGACTTATATTC
AGAGACTGTGCAAGGACGA -> GAGACTGTGCAAGGACGAT
AGAGAGCTGGGCGAAATGA -> GAGAGCTGGGCGAAATGAG
AGAGAGGTGTACGCACTCC -> GAGAGGTGTACGCACTCCG
AGAGCTCACTATATATCCG -> GAGCTCACTATATATCCGA
AGAGCTGGCCGCACGCTAC -> GAGCTGGCCGCACGCTACA
AGAGCTGGGCGAAATGAGT -> GAGCTGGGCGAAATGAGTC
AGAGGAAGGGTCTCGGGCA -> GAGGAAGGGTCTCGGGCAC
AGAGGTGTACGCACTCCGT -> GAGGTGTACGCACTCCGTG
AGAGTAAGACAGGCTTAAT -> GAGTAAGACAGGCTTAATG
AGATACCTCCCCTTTCACA -> GATACCTCCCCTTTCACAT
AGATATGAGTTTGCATTCT -> GATATGAGTTTGCATTCTC
AGATGCTATAGCAGCCCCG -> GATGCTATAGCAGCCCCGA
AGATTAGAACCCTTCTGCG -> GATTAGAACCCTTCTGCGG
AGATTAGCTCACGTGCTGC -> GATTAGCTCACGTGCTGCA
AGATTCGAATGGTGACGAC -> GATTCGAATGGTGACGACT
AGATTGTATAATCTTTTAG -> GATTGTATAATCTTTTAGA
AGATTTGCCGGTCTAATCA -> GATTTGCCGGTCTAATCAC
AGCAAATTTAATGGAATGC -> GCAAATTTAATGGAATGCC
AGCAACACCTGCCTAGGAC -> GCAACACCTGCCTAGGACC
AGCAACACCTGCCTAGGCC -> GCAACACCTGCCTAGGCCT
AGCAACACCTGCCTAGGGC -> GCAACACCTGCCTAGGGCC
AGCAACACCTGCCTAGGTA -> GCAACACCTGCCTAGGTAA
AGCACTCCCGGCTTGAACT -> GCACTCCCGGCTTGAACTT
AGCAGAAGCGCGCCACCCT -> GCAGAAGCGCGCCACCCTA
AGCAGCCCCGAGATTGTAT -> GCAGCCCCGAGATTGTATA
AGCATTATTAGTAGAAATT -> GCATTATTAGTAGAAATTG
AGCCAACCACAGCTCCCTT -> GCCAACCACAGCTCCCTTG
AGCCATTATTCCCCGATCG -> GCCATTATTCCCCGATCGT
AGCCCCGAGATTGTATAAT -> GCCCCGAGATTGTATAATC
AGCCCGCATTCACCTCAAT -> GCCCGCATTCACCTCAATC
AGCCCGTTATCTGCTCGCA -> GCCCGTTATCTGCTCGCAA
AGCCCTGCCCCCCTTTTAG -> GCCCTGCCCCCCTTTTAGT
AGCCCTGTTACTACTCGGC -> GCCCTGTTACTACTCGGCG
AGCCCTTGCTTCGAATGAG -> GCCCTTGCTTCGAATGAGA
AGCCGTACTGCGAAGGGAC -> GCCGTACTGCGAAGGGACG
AGCCTGGGGATTAGCGAGT -> GCCTGGGGATTAGCGAGTG
AGCGAGTGGGTATCCAAAT -> GCGAGTGGGTATCCAAATG
AGCGCACTAATGCCAACTG -> GCGCACTAATGCCAACTGG
AGCGCGCCACCCTAAAATA -> GCGCGCCACCCTAAAATAA
AGCGCTCCAAACTCCTCTT -> GCGCTCCAAACTCCTCTTT
AGCGCTTCGTCTTCTTATT -> GCGCTTCGTCTTCTTATTT
AGCGTACCGGTGCTGCATG -> GCGTACCGGTGCTGCATGA
AGCTCACGTGCTGCATGAA -> GCTCACGTGCTGCATGAAC
AGCTCACTATATATCCGAG -> GCTCACTATATATCCGAGG
AGCTCCACACACTTTGTAC -> GCTCCACACACTTTGTACC
AGCTCCCTTGACTACTATA -> GCTCCCTTGACTACTATAT
AGCTGAGCCTGGGGATTAG -> GCTGAGCCTGGGGATTAGC
AGCTGGCCGCACGCTACAT -> GCTGGCCGCACGCTACATT
AGCTGGGCGAAATGAGTCT -> GCTGGGCGAAATGAGTCTC
AGCTTCCTCTGAAAAGTGC -> GCTTCCTCTGAAAAGTGCC
AGCTTTTAGTCAGGGAGGG -> GCTTTTAGTCAGGGAGGGC
AGGAAGGGTCTCGGGCACC -> GGAAGGGTCTCGGGCACCG
AGGACAAGCTCCACACACT -> GGACAAGCTCCACACACTT
AGGACCGGTTTACGGACTG -> GGACCGGTTTACGGACTGT
AGGACGATCCAGACTGTCG -> GGACGATCCAGACTGTCGA
AGGACGATCCCGTGGAGGG -> GGACGATCCCGTGGAGGGC
AGGACGATCCCGTTAATCC -> GGACGATCCCGTTAATCCA
AGGACGATCCGCTAAACGG -> GGACGATCCGCTAAACGGG
AGGAGAGAGCTGGGCGAAA -> GGAGAGAGCTGGGCGAAAT
AGGAGGCGCCCGGCTTTCA -> GGAGGCGCCCGGCTTTCAC
AGGCAAGGCGTTGTGTAGG -> GGCAAGGCGTTGTGTAGGA
AGGCCTGCTGCGGCGACTG -> GGCCTGCTGCGGCGACTGT
AGGCGCCCGGCTTTCACGC -> GGCGCCCGGCTTTCACGCC
AGGCGGTCCTGACTTTCCA -> GGCGGTCCTGACTTTCCAT
AGGCGTTGTGTAGGACAAG -> GGCGTTGTGTAGGACAAGC
AGGCTTAATGCGACTTTTC -> GGCTTAATGCGACTTTTCC
AGGGACGTGAAGACTAAGC -> GGGACGTGAAGACTAAGCG
AGGGACTACGAACTGACCT -> GGGACTACGAACTGACCTC
AGGGAGGGCGCTACGAGTA -> GGGAGGGCGCTACGAGTAA
AGGGCCATGACAGAGACTG -> GGGCCATGACAGAGACTGT
AGGGCCTGGTCCGTTCCGG -> GGGCCTGGTCCGTTCCGGC
AGGGCGCTACGAGTAAGCC -> GGGCGCTACGAGTAAGCCC
AGGGCGGCTGTTCGGCAGA -> GGGCGGCTGTTCGGCAGAG
AGGGCTGTCGGTCGTCCAC -> GGGCTGTCGGTCGTCCACT
AGGGGTTTGCAAGCAAATT -> GGGGTTTGCAAGCAAATTT
AGGGTAGCGCTTCGTCTTC -> GGGTAGCGCTTCGTCTTCT
AGGGTCTCGGGCACCGACT -> GGGTCTCGGGCACCGACTT
AGGTAATTTTTGTGGACTG -> GGTAATTTTTGTGGACTGT
AGGTATTGGGATCATGTAT -> GGTATTGGGATCATGTATA
AGGTGTACGCACTCCGTGA -> GGTGTACGCACTCCGTGAA
AGTAAGACAGGCTTAATGC -> GTAAGACAGGCTTAATGCG
AGTAAGCCCGTTATCTGCT -> GTAAGCCCGTTATCTGCTC
AGTAAGCCCTGTTACTACT -> GTAAGCCCTGTTACTACTC
AGTAGAAATTGACAGGAGG -> GTAGAAATTGACAGGAGGC
AGTAGATTAGCTCACGTGC -> GTAGATTAGCTCACGTGCT
AGTCAGGGAGGGCGCTACG -> GTCAGGGAGGGCGCTACGA
AGTCCGGATATGGAGAGAA -> GTCCGGATATGGAGAGAAT
AGTCTCGAACCCACGCGGC -> GTCTCGAACCCACGCGGCC
AGTGACGCTATCCACATCC -> GTGACGCTATCCACATCCG
AGTGATGCCTCGTCAGAAA -> GTGATGCCTCGTCAGAAAT
AGTGATTGGTGTCGACCAA -> GTGATTGGTGTCGACCAAC
AGTGCCGAGATGCTATAGC -> GTGCCGAGATGCTATAGCA
AGTGGGGTCTAGCAGAAGC -> GTGGGGTCTAGCAGAAGCG
AGTGGGTATCCAAATGTGA -> GTGGGTATCCAAATGTGAT
AGTTACACATCGACTCCCG -> GTTACACATCGACTCCCGG
AGTTAGAACGTTCCTAACT -> GTTAGAACGTTCCTAACTA
AGTTGACGTACGCATCATA -> GTTGACGTACGCATCATAC
AGTTTGCATTCTCCAACAA -> GTTTGCATTCTCCAACAAA
ATAAACAGGGTAGCGCTTC -> TAAACAGGGTAGCGCTTCG
ATAAAGCTTCCTCTGAAAA -> TAAAGCTTCCTCTGAAAAG
ATAAAGGGCCTGGTCCGTT -> TAAAGGGCCTGGTCCGTTC
ATAACTAGGGGTTTGCAAG -> TAACTAGGGGTTTGCAAGC
ATAATCTTTTAGACAACCC -> TAATCTTTTAGACAACCCT
ATACACTCCTATGACTGCA -> TACACTCCTATGACTGCAC
ATACAGAGTAAGACAGGCT -> TACAGAGTAAGACAGGCTT
ATACAGATACCTCCCCTTT -> TACAGATACCTCCCCTTTC
ATACCGTACGACCCCGAAA -> TACCGTACGACCCCGAAAA
ATACCTCCCCTTTCACATG -> TACCTCCCCTTTCACATGC
ATAGACTGGCTATCCTTTG -> TAGACTGGCTATCCTTTGC
ATAGCAGCCCCGAGATTGT -> TAGCAGCCCCGAGATTGTA
ATATAAAGCTTCCTCTGAA -> TATAAAGCTTCCTCTGAAA
ATATATCCGAGGCAAGGCG -> TATATCCGAGGCAAGGCGT
ATATCCGAGGCAAGGCGTT -> TATCCGAGGCAAGGCGTTG
ATATGAGTTTGCATTCTCC -> TATGAGTTTGCATTCTCCA
ATATGGAGAGAATTGGACT -> TATGGAGAGAATTGGACTT
ATATTCTTAACCACGCGCG -> TATTCTTAACCACGCGCGT
ATCAAAATACAGAGTAAGA -> TCAAAATACAGAGTAAGAC
ATCACACAATCCCGACAGG -> TCACACAATCCCGACAGGT
ATCATACACTCCTATGACT -> TCATACACTCCTATGACTG
ATCATGTATAACTAGGGGT -> TCATGTATAACTAGGGGTT
ATCCAAATGTGATCCGTTA -> TCCAAATGTGATCCGTTAG
ATCCACATCCGATTAAGAC -> TCCACATCCGATTAAGACT
ATCCACGGTTATTAACAAG -> TCCACGGTTATTAACAAGT
ATCCAGACTGTCGATTTCC -> TCCAGACTGTCGATTTCCT
ATCCCGACAGGTATTGGGA -> TCCCGACAGGTATTGGGAT
ATCCCGTGGAGGGCGGCTG -> TCCCGTGGAGGGCGGCTGT
ATCCCGTTAATCCACGGTT -> TCCCGTTAATCCACGGTTA
ATCCGAGGCAAGGCGTTGT -> TCCGAGGCAAGGCGTTGTG
ATCCGATTAAGACTTGAAG -> TCCGATTAAGACTTGAAGC
ATCCGCTAAACGGGCGCCC -> TCCGCTAAACGGGCGCCCT
ATCCGTTAGAACGGAGCAT -> TCCGTTAGAACGGAGCATT
ATCCTTTGCATGGAGCTGA -> TCCTTTGCATGGAGCTGAG
ATCGACGGATGAGGGACTA -> TCGACGGATGAGGGACTAC
ATCGACTCCCGGCTCTCCA -> TCGACTCCCGGCTCTCCAG
ATCGATGGGGAAGCAACAC -> TCGATGGGGAAGCAACACC
ATCGCAGCGCACTAATGCC -> TCGCAGCGCACTAATGCCA
ATCGGATCGGGATCTTTTT -> TCGGATCGGGATCTTTTTC
ATCGGGATCTTTTTCTCTT -> TCGGGATCTTTTTCTCTTT
ATCGTACTGTGTCTAACGG -> TCGTACTGTGTCTAACGGG
ATCGTGTCCCCGCACGGAT -> TCGTGTCCCCGCACGGATG
ATCGTTTATAAACAGGGTA -> TCGTTTATAAACAGGGTAG
ATCTCCGAGGCATCGGAGG -> TCTCCGAGGCATCGGAGGC
ATCTGCTCGCAATCGTACT -> TCTGCTCGCAATCGTACTG
ATCTTTTAGACAACCCTTC -> TCTTTTAGACAACCCTTCA
ATCTTTTTCTCTTTCGCAT -> TCTTTTTCTCTTTCGCATA
ATGAACTCGTGCCTTCCGG -> TGAACTCGTGCCTTCCGGC
ATGACAGAGACTGTGCAAG -> TGACAGAGACTGTGCAAGG
ATGACATTCGGCTCCTGGC -> TGACATTCGGCTCCTGGCT
ATGACTAGGAGAGAGCTGG -> TGACTAGGAGAGAGCTGGG
ATGACTGCACAACGTATGC -> TGACTGCACAACGTATGCC
ATGAGACAGAGAGGTGTAC -> TGAGACAGAGAGGTGTACG
ATGAGGGACTACGAACTGA -> TGAGGGACTACGAACTGAC
ATGAGTCTCGAACCCACGC -> TGAGTCTCGAACCCACGCG
ATGAGTTTGCATTCTCCAA -> TGAGTTTGCATTCTCCAAC
ATGATGGGGAATGCCGCAT -> TGATGGGGAATGCCGCATG
ATGCCAACTGGTGCATTTG -> TGCCAACTGGTGCATTTGT
ATGCCAAGTAGATTAGCTC -> TGCCAAGTAGATTAGCTCA
ATGCCCGGGCTATTTAACC -> TGCCCGGGCTATTTAACCT
ATGCCGCATGTCGAGGGCT -> TGCCGCATGTCGAGGGCTG
ATGCCGGAAAACGAAAATG -> TGCCGGAAAACGAAAATGG
ATGCCTCACAGTTAGAACG -> TGCCTCACAGTTAGAACGT
ATGCCTCGTCAGAAATGAC -> TGCCTCGTCAGAAATGACT
ATGCGAAAGAAGATTTGCC -> TGCGAAAGAAGATTTGCCG
ATGCGACTTTTCCTATCGA -> TGCGACTTTTCCTATCGAC
ATGCGGTCGTATCGATGGG -> TGCGGTCGTATCGATGGGG
ATGCTATAGCAGCCCCGAG -> TGCTATAGCAGCCCCGAGA
ATGCTCCGCCCGTTTTCCG -> TGCTCCGCCCGTTTTCCGG
ATGGAATGCCTCACAGTTA -> TGGAATGCCTCACAGTTAG
ATGGAGAGAATTGGACTTA -> TGGAGAGAATTGGACTTAT
ATGGAGCTGAGCCTGGGGA -> TGGAGCTGAGCCTGGGGAT
ATGGGACGGTTCGGTCAAA -> TGGGACGGTTCGGTCAAAG
ATGGGGAAGCAACACCTGC -> TGGGGAAGCAACACCTGCC
ATGGGGAATGCCGCATGTC -> TGGGGAATGCCGCATGTCG
ATGGTCACTCTAACATTGG -> TGGTCACTCTAACATTGGC
ATGGTGACGACTGCAGACG -> TGGTGACGACTGCAGACGC
ATGGTTAATTCTTCGCGGC -> TGGTTAATTCTTCGCGGCG
ATGTATAACTAGGGGTTTG -> TGTATAACTAGGGGTTTGC
ATGTCGAGGGCTGTCGGTC -> TGTCGAGGGCTGTCGGTCG
ATGTGATCCGTTAGAACGG -> TGTGATCCGTTAGAACGGA
ATTAACAAGTCCGGATATG -> TTAACAAGTCCGGATATGG
ATTAAGACTTGAAGCCAAC -> TTAAGACTTGAAGCCAACC
ATTACGACGGTAAATCAAA -> TTACGACGGTAAATCAAAA
ATTAGAACCCTTCTGCGGC -> TTAGAACCCTTCTGCGGCT
ATTAGCGAGTGGGTATCCA -> TTAGCGAGTGGGTATCCAA
ATTAGCTCACGTGCTGCAT -> TTAGCTCACGTGCTGCATG
ATTAGTAGAAATTGACAGG -> TTAGTAGAAATTGACAGGA
ATTATTAGTAGAAATTGAC -> TTATTAGTAGAAATTGACA
ATTATTCATAGACTGGCTA -> TTATTCATAGACTGGCTAT
ATTATTCCCCGATCGTTTA -> TTATTCCCCGATCGTTTAT
ATTCACCTCAATCGCAGCG -> TTCACCTCAATCGCAGCGC
ATTCATAGACTGGCTATCC -> TTCATAGACTGGCTATCCT
ATTCCCCGATCGTTTATAA -> TTCCCCGATCGTTTATAAA
ATTCGAATGGTGACGACTG -> TTCGAATGGTGACGACTGC
ATTCGGCTCCTGGCTGGAC -> TTCGGCTCCTGGCTGGACG
ATTCTCCAACAAACCGCAT -> TTCTCCAACAAACCGCATG
ATTCTTAACCACGCGCGTA -> TTCTTAACCACGCGCGTAT
ATTCTTCGCGGCGAACTCG -> TTCTTCGCGGCGAACTCGT
ATTGACAGGAGGCGCCCGG -> TTGACAGGAGGCGCCCGGC
ATTGCAAGCAACACCTGCC -> TTGCAAGCAACACCTGCCT
ATTGGACTTATATTCTTAA -> TTGGACTTATATTCTTAAC
ATTGGCCCTGTGACCACTT -> TTGGCCCTGTGACCACTTA
ATTGGGATCATGTATAACT -> TTGGGATCATGTATAACTA
ATTGGTGTCGACCAACGCC -> TTGGTGTCGACCAACGCCA
ATTGTATAATCTTTTAGAC -> TTGTATAATCTTTTAGACA
ATTGTCTGATGCCGGAAAA -> TTGTCTGATGCCGGAAAAC
ATTTAACCTCGTCCCCAAG -> TTTAACCTCGTCCCCAAGC
ATTTAATGGAATGCCTCAC -> TTTAATGGAATGCCTCACA
ATTTACTCTTCCGGCCGTA -> TTTACTCTTCCGGCCGTAA
ATTTAGATATGAGTTTGCA -> TTTAGATATGAGTTTGCAT
ATTTCCTGCTAAAACAGAC -> TTTCCTGCTAAAACAGACA
ATTTCCTGGTCTGCCCTTA -> TTTCCTGGTCTGCCCTTAC
ATTTCTCTTATGGGACGGT -> TTTCTCTTATGGGACGGTT
ATTTGCCGGTCTAATCACA -> TTTGCCGGTCTAATCACAC
ATTTGTTTAGTAAGCCCTG -> TTTGTTTAGTAAGCCCTGT
ATTTTCTAATGCCAAGTAG -> TTTTCTAATGCCAAGTAGA
ATTTTTGTGGACTGTGCAA -> TTTTTGTGGACTGTGCAAG
CAAAATACAGAGTAAGACA -> AAAATACAGAGTAAGACAG
CAAACCGCATGCGGTCGTA -> AAACCGCATGCGGTCGTAT
CAAACTCCTCTTTTGGGTC -> AAACTCCTCTTTTGGGTCG
CAAAGATTAGAACCCTTCT -> AAAGATTAGAACCCTTCTG
CAAATGTGATCCGTTAGAA -> AAATGTGATCCGTTAGAAC
CAAATTTAATGGAATGCCT -> AAATTTAATGGAATGCCTC
CAACAAACCGCATGCGGTC -> AACAAACCGCATGCGGTCG
CAACACCTGCCTAGGACCG -> AACACCTGCCTAGGACCGG
CAACACCTGCCTAGGCCTG -> AACACCTGCCTAGGCCTGC
CAACACCTGCCTAGGGCCA -> AACACCTGCCTAGGGCCAT
CAACACCTGCCTAGGTAAT -> AACACCTGCCTAGGTAATT
CAACCACAGCTCCCTTGAC -> AACCACAGCTCCCTTGACT
CAACCCTTCAGAAACGGAA -> AACCCTTCAGAAACGGAAG
CAACGCCATTACGACGGTA -> AACGCCATTACGACGGTAA
CAACGTATGCCCGGGCTAT -> AACGTATGCCCGGGCTATT
CAACTGGTGCATTTGTTTA -> AACTGGTGCATTTGTTTAG
CAAGCAAATTTAATGGAAT -> AAGCAAATTTAATGGAATG
CAAGCAACACCTGCCTAGG -> AAGCAACACCTGCCTAGGC
CAAGCACTCCCGGCTTGAA -> AAGCACTCCCGGCTTGAAC
CAAGCTCCACACACTTTGT -> AAGCTCCACACACTTTGTA
CAAGGACGATCCAGACTGT -> AAGGACGATCCAGACTGTC
CAAGGACGATCCCGTGGAG -> AAGGACGATCCCGTGGAGG
CAAGGACGATCCCGTTAAT -> AAGGACGATCCCGTTAATC
CAAGGACGATCCGCTAAAC -> AAGGACGATCCGCTAAACG
CAAGGCGTTGTGTAGGACA -> AAGGCGTTGTGTAGGACAA
CAAGTAGATTAGCTCACGT -> AAGTAGATTAGCTCACGTG
CAAGTCCGGATATGGAGAG -> AAGTCCGGATATGGAGAGA
CAAGTGACGCTATCCACAT -> AAGTGACGCTATCCACATC
CAAGTTGACGTACGCATCA -> AAGTTGACGTACGCATCAT
CAATCCCGACAGGTATTGG -> AATCCCGACAGGTATTGGG
CAATCGCAGCGCACTAATG -> AATCGCAGCGCACTAATGC
CAATCGTACTGTGTCTAAC -> AATCGTACTGTGTCTAACG
CAATTTCTCTTATGGGACG -> AATTTCTCTTATGGGACGG
CACAACGTATGCCCGGGCT -> ACAACGTATGCCCGGGCTA
CACAATCCCGACAGGTATT -> ACAATCCCGACAGGTATTG
CACACAATCCCGACAGGTA -> ACACAATCCCGACAGGTAT
CACACACTTTGTACCTTTT -> ACACACTTTGTACCTTTTA
CACACTTTGTACCTTTTAC -> ACACTTTGTACCTTTTACT
CACAGCTCCCTTGACTACT -> ACAGCTCCCTTGACTACTA
CACAGTTAGAACGTTCCTA -> ACAGTTAGAACGTTCCTAA
CACATCCGATTAAGACTTG -> ACATCCGATTAAGACTTGA
CACATCGACTCCCGGCTCT -> ACATCGACTCCCGGCTCTC
CACATGCGAAAGAAGATTT -> ACATGCGAAAGAAGATTTG
CACCAGCGTACCGGTGCTG -> ACCAGCGTACCGGTGCTGC
CACCCTAAAATAAAGGGCC -> ACCCTAAAATAAAGGGCCT
CACCCTAGCCCTTGCTTCG -> ACCCTAGCCCTTGCTTCGA
CACCGACTTTCGGGTCATG -> ACCGACTTTCGGGTCATGC
CACCTCAATCGCAGCGCAC -> ACCTCAATCGCAGCGCACT
CACCTGCCTAGGACCGGTT -> ACCTGCCTAGGACCGGTTT
CACCTGCCTAGGCCTGCTG -> ACCTGCCTAGGCCTGCTGC
CACCTGCCTAGGGCCATGA -> ACCTGCCTAGGGCCATGAC
CACCTGCCTAGGTAATTTT -> ACCTGCCTAGGTAATTTTT
CACGCCTATTGTCTGATGC -> ACGCCTATTGTCTGATGCC
CACGCCTCGGGGCCGGCAC -> ACGCCTCGGGGCCGGCACC
CACGCGCGTATCGTGTCCC -> ACGCGCGTATCGTGTCCCC
CACGCGGCCGACTCTGAAC -> ACGCGGCCGACTCTGAACC
CACGCTACATTTACTCTTC -> ACGCTACATTTACTCTTCC
CACGGATGGTTAATTCTTC -> ACGGATGGTTAATTCTTCG
CACGGTTATTAACAAGTCC -> ACGGTTATTAACAAGTCCG
CACGTGCTGCATGAACTCG -> ACGTGCTGCATGAACTCGT
CACTAATGCCAACTGGTGC -> ACTAATGCCAACTGGTGCA
CACTATATATCCGAGGCAA -> ACTATATATCCGAGGCAAG
CACTCCCGGCTTGAACTTT -> ACTCCCGGCTTGAACTTTT
CACTCCGTGAAGCCATTAT -> ACTCCGTGAAGCCATTATT
CACTCCTATGACTGCACAA -> ACTCCTATGACTGCACAAC
CACTCTAACATTGGCCCTG -> ACTCTAACATTGGCCCTGT
CACTTAGTTACACATCGAC -> ACTTAGTTACACATCGACT
CACTTTACCTTCGGAACAA -> ACTTTACCTTCGGAACAAG
CACTTTGTACCTTTTACTT -> ACTTTGTACCTTTTACTTG
CAGAAACGGAAGTGATTGG -> AGAAACGGAAGTGATTGGT
CAGAAATGACTAGGAGAGA -> AGAAATGACTAGGAGAGAG
CAGAAGCGCGCCACCCTAA -> AGAAGCGCGCCACCCTAAA
CAGACAAGTGACGCTATCC -> AGACAAGTGACGCTATCCA
CAGACGCGTCTCTCGTAAA -> AGACGCGTCTCTCGTAAAG
CAGACGGTACGGCATACCG -> AGACGGTACGGCATACCGT
CAGACTGTCGATTTCCTGC -> AGACTGTCGATTTCCTGCT
CAGAGACTGTGCAAGGACG -> AGAGACTGTGCAAGGACGA
CAGAGAGGTGTACGCACTC -> AGAGAGGTGTACGCACTCC
CAGAGGAAGGGTCTCGGGC -> AGAGGAAGGGTCTCGGGCA
CAGAGTAAGACAGGCTTAA -> AGAGTAAGACAGGCTTAAT
CAGATACCTCCCCTTTCAC -> AGATACCTCCCCTTTCACA
CAGATTCGAATGGTGACGA -> AGATTCGAATGGTGACGAC
CAGCCCCGAGATTGTATAA -> AGCCCCGAGATTGTATAAT
CAGCCCGCATTCACCTCAA -> AGCCCGCATTCACCTCAAT
CAGCCCTGCCCCCCTTTTA -> AGCCCTGCCCCCCTTTTAG
CAGCCGTACTGCGAAGGGA -> AGCCGTACTGCGAAGGGAC
CAGCGCACTAATGCCAACT -> AGCGCACTAATGCCAACTG
CAGCGTACCGGTGCTGCAT -> AGCGTACCGGTGCTGCATG
CAGCTCCCTTGACTACTAT -> AGCTCCCTTGACTACTATA
CAGGAGGCGCCCGGCTTTC -> AGGAGGCGCCCGGCTTTCA
CAGGCGGTCCTGACTTTCC -> AGGCGGTCCTGACTTTCCA
CAGGCTTAATGCGACTTTT -> AGGCTTAATGCGACTTTTC
CAGGGAGGGCGCTACGAGT -> AGGGAGGGCGCTACGAGTA
CAGGGTAGCGCTTCGTCTT -> AGGGTAGCGCTTCGTCTTC
CAGGTATTGGGATCATGTA -> AGGTATTGGGATCATGTAT
CAGTTAGAACGTTCCTAAC -> AGTTAGAACGTTCCTAACT
CATACACTCCTATGACTGC -> ATACACTCCTATGACTGCA
CATACAGATACCTCCCCTT -> ATACAGATACCTCCCCTTT
CATACCGTACGACCCCGAA -> ATACCGTACGACCCCGAAA
CATAGACTGGCTATCCTTT -> ATAGACTGGCTATCCTTTG
CATCATACACTCCTATGAC -> ATCATACACTCCTATGACT
CATCCGATTAAGACTTGAA -> ATCCGATTAAGACTTGAAG
CATCGACTCCCGGCTCTCC -> ATCGACTCCCGGCTCTCCA
CATGAACTCGTGCCTTCCG -> ATGAACTCGTGCCTTCCGG
CATGACAGAGACTGTGCAA -> ATGACAGAGACTGTGCAAG
CATGACATTCGGCTCCTGG -> ATGACATTCGGCTCCTGGC
CATGATGGGGAATGCCGCA -> ATGATGGGGAATGCCGCAT
CATGCGAAAGAAGATTTGC -> ATGCGAAAGAAGATTTGCC
CATGCGGTCGTATCGATGG -> ATGCGGTCGTATCGATGGG
CATGCTCCGCCCGTTTTCC -> ATGCTCCGCCCGTTTTCCG
CATGGAGCTGAGCCTGGGG -> ATGGAGCTGAGCCTGGGGA
CATGTATAACTAGGGGTTT -> ATGTATAACTAGGGGTTTG
CATGTCGAGGGCTGTCGGT -> ATGTCGAGGGCTGTCGGTC
CATTACGACGGTAAATCAA -> ATTACGACGGTAAATCAAA
CATTATTAGTAGAAATTGA -> ATTATTAGTAGAAATTGAC
CATTATTCCCCGATCGTTT -> ATTATTCCCCGATCGTTTA
CATTCACCTCAATCGCAGC -> ATTCACCTCAATCGCAGCG
CATTCGGCTCCTGGCTGGA -> ATTCGGCTCCTGGCTGGAC
CATTCTCCAACAAACCGCA -> ATTCTCCAACAAACCGCAT
CATTGGCCCTGTGACCACT -> ATTGGCCCTGTGACCACTT
CATTTACTCTTCCGGCCGT -> ATTTACTCTTCCGGCCGTA
CATTTAGATATGAGTTTGC -> ATTTAGATATGAGTTTGCA
CATTTGTTTAGTAAGCCCT -> ATTTGTTTAGTAAGCCCTG
CCAAACTCCTCTTTTGGGT -> CAAACTCCTCTTTTGGGTC
CCAAATGTGATCCGTTAGA -> CAAATGTGATCCGTTAGAA
CCAACAAACCGCATGCGGT -> CAACAAACCGCATGCGGTC
CCAACCACAGCTCCCTTGA -> CAACCACAGCTCCCTTGAC
CCAACGCCATTACGACGGT -> CAACGCCATTACGACGGTA
CCAACTGGTGCATTTGTTT -> CAACTGGTGCATTTGTTTA
CCAAGCACTCCCGGCTTGA -> CAAGCACTCCCGGCTTGAA
CCAAGTAGATTAGCTCACG -> CAAGTAGATTAGCTCACGT
CCACACACTTTGTACCTTT -> CACACACTTTGTACCTTTT
CCACAGCTCCCTTGACTAC -> CACAGCTCCCTTGACTACT
CCACATCCGATTAAGACTT -> CACATCCGATTAAGACTTG
CCACCCTAAAATAAAGGGC -> CACCCTAAAATAAAGGGCC
CCACGCGCGTATCGTGTCC -> CACGCGCGTATCGTGTCCC
CCACGCGGCCGACTCTGAA -> CACGCGGCCGACTCTGAAC
CCACGGTTATTAACAAGTC -> CACGGTTATTAACAAGTCC
CCACTTAGTTACACATCGA -> CACTTAGTTACACATCGAC
CCACTTTACCTTCGGAACA -> CACTTTACCTTCGGAACAA
CCAGACTGTCGATTTCCTG -> CAGACTGTCGATTTCCTGC
CCAGATTCGAATGGTGACG -> CAGATTCGAATGGTGACGA
CCAGCCCTGCCCCCCTTTT -> CAGCCCTGCCCCCCTTTTA
CCAGCGTACCGGTGCTGCA -> CAGCGTACCGGTGCTGCAT
CCAGGCGGTCCTGACTTTC -> CAGGCGGTCCTGACTTTCC
CCATGACAGAGACTGTGCA -> CATGACAGAGACTGTGCAA
CCATGACATTCGGCTCCTG -> CATGACATTCGGCTCCTGG
CCATTACGACGGTAAATCA -> CATTACGACGGTAAATCAA
CCATTATTCCCCGATCGTT -> CATTATTCCCCGATCGTTT
CCATTTAGATATGAGTTTG -> CATTTAGATATGAGTTTGC
CCCAAGCACTCCCGGCTTG -> CCAAGCACTCCCGGCTTGA
CCCACGCGGCCGACTCTGA -> CCACGCGGCCGACTCTGAA
CCCCAAGCACTCCCGGCTT -> CCCAAGCACTCCCGGCTTG
CCCCCCTTTTAGTGATGCC -> CCCCCTTTTAGTGATGCCT
CCCCCTTTTAGTGATGCCT -> CCCCTTTTAGTGATGCCTC
CCCCGAAAATCTCCGAGGC -> CCCGAAAATCTCCGAGGCA
CCCCGAGATTGTATAATCT -> CCCGAGATTGTATAATCTT
CCCCGATCGTTTATAAACA -> CCCGATCGTTTATAAACAG
CCCCGCACGGATGGTTAAT -> CCCGCACGGATGGTTAATT
CCCCTTTCACATGCGAAAG -> CCCTTTCACATGCGAAAGA
CCCCTTTTAGTGATGCCTC -> CCCTTTTAGTGATGCCTCG
CCCGAAAATCTCCGAGGCA -> CCGAAAATCTCCGAGGCAT
CCCGACAGGTATTGGGATC -> CCGACAGGTATTGGGATCA
CCCGAGATTGTATAATCTT -> CCGAGATTGTATAATCTTT
CCCGATCGTTTATAAACAG -> CCGATCGTTTATAAACAGG
CCCGCACGGATGGTTAATT -> CCGCACGGATGGTTAATTC
CCCGCATTCACCTCAATCG -> CCGCATTCACCTCAATCGC
CCCGGCTCTCCAGGCGGTC -> CCGGCTCTCCAGGCGGTCC
CCCGGCTTGAACTTTTTCT -> CCGGCTTGAACTTTTTCTC
CCCGGCTTTCACGCCTCGG -> CCGGCTTTCACGCCTCGGG
CCCGGGCTATTTAACCTCG -> CCGGGCTATTTAACCTCGT
CCCGTGGAGGGCGGCTGTT -> CCGTGGAGGGCGGCTGTTC
CCCGTTAATCCACGGTTAT -> CCGTTAATCCACGGTTATT
CCCGTTATCTGCTCGCAAT -> CCGTTATCTGCTCGCAATC
CCCGTTTTCCGGGCTCCAG -> CCGTTTTCCGGGCTCCAGA
CCCTAAAATAAAGGGCCTG -> CCTAAAATAAAGGGCCTGG
CCCTAGCCCTTGCTTCGAA -> CCTAGCCCTTGCTTCGAAT
CCCTGCCCCCCTTTTAGTG -> CCTGCCCCCCTTTTAGTGA
CCCTGTCGTGGTGGGAGAG -> CCTGTCGTGGTGGGAGAGC
CCCTGTGACCACTTAGTTA -> CCTGTGACCACTTAGTTAC
CCCTGTTACTACTCGGCGC -> CCTGTTACTACTCGGCGCT
CCCTTACTCGATTTTCTAA -> CCTTACTCGATTTTCTAAT
CCCTTCAGAAACGGAAGTG -> CCTTCAGAAACGGAAGTGA
CCCTTCTGCGGCTAAACGT -> CCTTCTGCGGCTAAACGTA
CCCTTGACTACTATATAAA -> CCTTGACTACTATATAAAG
CCCTTGCTTCGAATGAGAC -> CCTTGCTTCGAATGAGACA
CCCTTTCACATGCGAAAGA -> CCTTTCACATGCGAAAGAA
CCCTTTTAGTGATGCCTCG -> CCTTTTAGTGATGCCTCGT
CCGAAAATCTCCGAGGCAT -> CGAAAATCTCCGAGGCATC
CCGACAGGTATTGGGATCA -> CGACAGGTATTGGGATCAT
CCGACTCTGAACCATGACA -> CGACTCTGAACCATGACAT
CCGACTTTCGGGTCATGCT -> CGACTTTCGGGTCATGCTC
CCGAGATGCTATAGCAGCC -> CGAGATGCTATAGCAGCCC
CCGAGATTGTATAATCTTT -> CGAGATTGTATAATCTTTT
CCGAGGCAAGGCGTTGTGT -> CGAGGCAAGGCGTTGTGTA
CCGAGGCATCGGAGGCAAC -> CGAGGCATCGGAGGCAACG
CCGATCGTTTATAAACAGG -> CGATCGTTTATAAACAGGG
CCGATTAAGACTTGAAGCC -> CGATTAAGACTTGAAGCCA
CCGCACGCTACATTTACTC -> CGCACGCTACATTTACTCT
CCGCACGGATGGTTAATTC -> CGCACGGATGGTTAATTCT
CCGCATGCGGTCGTATCGA -> CGCATGCGGTCGTATCGAT
CCGCATGTCGAGGGCTGTC -> CGCATGTCGAGGGCTGTCG
CCGCATTCACCTCAATCGC -> CGCATTCACCTCAATCGCA
CCGCCCGTTTTCCGGGCTC -> CGCCCGTTTTCCGGGCTCC
CCGCTAAACGGGCGCCCTG -> CGCTAAACGGGCGCCCTGT
CCGGAAAACGAAAATGGTC -> CGGAAAACGAAAATGGTCA
CCGGATATGGAGAGAATTG -> CGGATATGGAGAGAATTGG
CCGGCACCAGCGTACCGGT -> CGGCACCAGCGTACCGGTG
CCGGCAGACGGTACGGCAT -> CGGCAGACGGTACGGCATA
CCGGCAGCCGTACTGCGAA -> CGGCAGCCGTACTGCGAAG
CCGGCCGTAAGCAACACCT -> CGGCCGTAAGCAACACCTG
CCGGCTCTCCAGGCGGTCC -> CGGCTCTCCAGGCGGTCCT
CCGGCTTGAACTTTTTCTC -> CGGCTTGAACTTTTTCTCC
CCGGCTTTCACGCCTCGGG -> CGGCTTTCACGCCTCGGGG
CCGGGCTATTTAACCTCGT -> CGGGCTATTTAACCTCGTC
CCGGGCTCCAGATTCGAAT -> CGGGCTCCAGATTCGAATG
CCGGTCTAATCACACAATC -> CGGTCTAATCACACAATCC
CCGGTGCTGCATGATGGGG -> CGGTGCTGCATGATGGGGA
CCGGTTTACGGACTGTGCA -> CGGTTTACGGACTGTGCAA
CCGTAAGCAACACCTGCCT -> CGTAAGCAACACCTGCCTA
CCGTACGACCCCGAAAATC -> CGTACGACCCCGAAAATCT
CCGTACTGCGAAGGGACGT -> CGTACTGCGAAGGGACGTG
CCGTGAAGCCATTATTCCC -> CGTGAAGCCATTATTCCCC
CCGTGGAGGGCGGCTGTTC -> CGTGGAGGGCGGCTGTTCG
CCGTGTTAACACGCCTATT -> CGTGTTAACACGCCTATTG
CCGTTAATCCACGGTTATT -> CGTTAATCCACGGTTATTA
CCGTTAGAACGGAGCATTA -> CGTTAGAACGGAGCATTAT
CCGTTATCTGCTCGCAATC -> CGTTATCTGCTCGCAATCG
CCGTTCCGGCAGACGGTAC -> CGTTCCGGCAGACGGTACG
CCGTTTTCCGGGCTCCAGA -> CGTTTTCCGGGCTCCAGAT
CCTAAAATAAAGGGCCTGG -> CTAAAATAAAGGGCCTGGT
CCTAACTAATTGCAAGCAA -> CTAACTAATTGCAAGCAAC
CCTAGCCCTTGCTTCGAAT -> CTAGCCCTTGCTTCGAATG
CCTAGGACCGGTTTACGGA -> CTAGGACCGGTTTACGGAC
CCTAGGCCTGCTGCGGCGA -> CTAGGCCTGCTGCGGCGAC
CCTAGGGCCATGACAGAGA -> CTAGGGCCATGACAGAGAC
CCTAGGTAATTTTTGTGGA -> CTAGGTAATTTTTGTGGAC
CCTATCGACGGATGAGGGA -> CTATCGACGGATGAGGGAC
CCTATGACTGCACAACGTA -> CTATGACTGCACAACGTAT
CCTATTGTCTGATGCCGGA -> CTATTGTCTGATGCCGGAA
CCTCAATCGCAGCGCACTA -> CTCAATCGCAGCGCACTAA
CCTCACAGTTAGAACGTTC -> CTCACAGTTAGAACGTTCC
CCTCACCCTAGCCCTTGCT -> CTCACCCTAGCCCTTGCTT
CCTCCCCTTTCACATGCGA -> CTCCCCTTTCACATGCGAA
CCTCGGGGCCGGCACCAGC -> CTCGGGGCCGGCACCAGCG
CCTCGTCAGAAATGACTAG -> CTCGTCAGAAATGACTAGG
CCTCGTCCCCAAGCACTCC -> CTCGTCCCCAAGCACTCCC
CCTCTGAAAAGTGCCGAGA -> CTCTGAAAAGTGCCGAGAT
CCTCTTATTATTCATAGAC -> CTCTTATTATTCATAGACT
CCTCTTTTGGGTCGTAGAG -> CTCTTTTGGGTCGTAGAGC
CCTGACTTTCCATTTAGAT -> CTGACTTTCCATTTAGATA
CCTGCCCCCCTTTTAGTGA -> CTGCCCCCCTTTTAGTGAT
CCTGCCTAGGACCGGTTTA -> CTGCCTAGGACCGGTTTAC
CCTGCCTAGGCCTGCTGCG -> CTGCCTAGGCCTGCTGCGG
CCTGCCTAGGGCCATGACA -> CTGCCTAGGGCCATGACAG
CCTGCCTAGGTAATTTTTG -> CTGCCTAGGTAATTTTTGT
CCTGCTAAAACAGACAAGT -> CTGCTAAAACAGACAAGTG
CCTGCTGCGGCGACTGTGC -> CTGCTGCGGCGACTGTGCA
CCTGGCTGGACGTACTGTT -> CTGGCTGGACGTACTGTTG
CCTGGGGATTAGCGAGTGG -> CTGGGGATTAGCGAGTGGG
CCTGGTCCGTTCCGGCAGA -> CTGGTCCGTTCCGGCAGAC
CCTGGTCTGCCCTTACTCG -> CTGGTCTGCCCTTACTCGA
CCTGTCGTGGTGGGAGAGC -> CTGTCGTGGTGGGAGAGCT
CCTGTGACCACTTAGTTAC -> CTGTGACCACTTAGTTACA
CCTGTTACTACTCGGCGCT -> CTGTTACTACTCGGCGCTG
CCTTACTCGATTTTCTAAT -> CTTACTCGATTTTCTAATG
CCTTCAGAAACGGAAGTGA -> CTTCAGAAACGGAAGTGAT
CCTTCCGGCAGCCGTACTG -> CTTCCGGCAGCCGTACTGC
CCTTCGGAACAAGTTGACG -> CTTCGGAACAAGTTGACGT
CCTTCTGCGGCTAAACGTA -> CTTCTGCGGCTAAACGTAA
CCTTGACTACTATATAAAG -> CTTGACTACTATATAAAGC
CCTTGCTTCGAATGAGACA -> CTTGCTTCGAATGAGACAG
CCTTGGCAGCCCGCATTCA -> CTTGGCAGCCCGCATTCAC
CCTTTCACATGCGAAAGAA -> CTTTCACATGCGAAAGAAG
CCTTTGCATGGAGCTGAGC -> CTTTGCATGGAGCTGAGCC
CCTTTTACTTGTTCGCCGT -> CTTTTACTTGTTCGCCGTG
CCTTTTAGTGATGCCTCGT -> CTTTTAGTGATGCCTCGTC
CGAAAATCTCCGAGGCATC -> GAAAATCTCCGAGGCATCG
CGAAAATGGTCACTCTAAC -> GAAAATGGTCACTCTAACA
CGAAAGAAGATTTGCCGGT -> GAAAGAAGATTTGCCGGTC
CGAAATGAGTCTCGAACCC -> GAAATGAGTCTCGAACCCA
CGAACCCACGCGGCCGACT -> GAACCCACGCGGCCGACTC
CGAACTCGTCCTTGGCAGC -> GAACTCGTCCTTGGCAGCC
CGAACTGACCTCACCCTAG -> GAACTGACCTCACCCTAGC
CGAAGGGACGTGAAGACTA -> GAAGGGACGTGAAGACTAA
CGAATGAGACAGAGAGGTG -> GAATGAGACAGAGAGGTGT
CGAATGGTGACGACTGCAG -> GAATGGTGACGACTGCAGA
CGACAGGTATTGGGATCAT -> GACAGGTATTGGGATCATG
CGACCAACGCCATTACGAC -> GACCAACGCCATTACGACG
CGACCCCGAAAATCTCCGA -> GACCCCGAAAATCTCCGAG
CGACGGATGAGGGACTACG -> GACGGATGAGGGACTACGA
CGACGGTAAATCAAAATAC -> GACGGTAAATCAAAATACA
CGACTCCCGGCTCTCCAGG -> GACTCCCGGCTCTCCAGGC
CGACTCTGAACCATGACAT -> GACTCTGAACCATGACATT
CGACTGCAGACGCGTCTCT -> GACTGCAGACGCGTCTCTC
CGACTGTGCAAGGACGATC -> GACTGTGCAAGGACGATCC
CGACTTTCGGGTCATGCTC -> GACTTTCGGGTCATGCTCC
CGACTTTTCCTATCGACGG -> GACTTTTCCTATCGACGGA
CGAGATGCTATAGCAGCCC -> GAGATGCTATAGCAGCCCC
CGAGATTGTATAATCTTTT -> GAGATTGTATAATCTTTTA
CGAGGCAAGGCGTTGTGTA -> GAGGCAAGGCGTTGTGTAG
CGAGGCATCGGAGGCAACG -> GAGGCATCGGAGGCAACGC
CGAGGGCTGTCGGTCGTCC -> GAGGGCTGTCGGTCGTCCA
CGAGTAAGCCCGTTATCTG -> GAGTAAGCCCGTTATCTGC
CGAGTGGGTATCCAAATGT -> GAGTGGGTATCCAAATGTG
CGATCCAGACTGTCGATTT -> GATCCAGACTGTCGATTTC
CGATCCCGTGGAGGGCGGC -> GATCCCGTGGAGGGCGGCT
CGATCCCGTTAATCCACGG -> GATCCCGTTAATCCACGGT
CGATCCGCTAAACGGGCGC -> GATCCGCTAAACGGGCGCC
CGATCGTTTATAAACAGGG -> GATCGTTTATAAACAGGGT
CGATGGGGAAGCAACACCT -> GATGGGGAAGCAACACCTG
CGATTAAGACTTGAAGCCA -> GATTAAGACTTGAAGCCAA
CGATTTCCTGCTAAAACAG -> GATTTCCTGCTAAAACAGA
CGATTTTCTAATGCCAAGT -> GATTTTCTAATGCCAAGTA
CGCAATCGTACTGTGTCTA -> GCAATCGTACTGTGTCTAA
CGCACGCTACATTTACTCT -> GCACGCTACATTTACTCTT
CGCACGGATGGTTAATTCT -> GCACGGATGGTTAATTCTT
CGCACTAATGCCAACTGGT -> GCACTAATGCCAACTGGTG
CGCACTCCGTGAAGCCATT -> GCACTCCGTGAAGCCATTA
CGCAGCGCACTAATGCCAA -> GCAGCGCACTAATGCCAAC
CGCATACAGATACCTCCCC -> GCATACAGATACCTCCCCT
CGCATCATACACTCCTATG -> GCATCATACACTCCTATGA
CGCATGCGGTCGTATCGAT -> GCATGCGGTCGTATCGATG
CGCATGTCGAGGGCTGTCG -> GCATGTCGAGGGCTGTCGG
CGCATTCACCTCAATCGCA -> GCATTCACCTCAATCGCAG
CGCCACCCTAAAATAAAGG -> GCCACCCTAAAATAAAGGG
CGCCATTACGACGGTAAAT -> GCCATTACGACGGTAAATC
CGCCCGGCTTTCACGCCTC -> GCCCGGCTTTCACGCCTCG
CGCCCGTTTTCCGGGCTCC -> GCCCGTTTTCCGGGCTCCA
CGCCCTGTCGTGGTGGGAG -> GCCCTGTCGTGGTGGGAGA
CGCCGTGTTAACACGCCTA -> GCCGTGTTAACACGCCTAT
CGCCTATTGTCTGATGCCG -> GCCTATTGTCTGATGCCGG
CGCCTCGGGGCCGGCACCA -> GCCTCGGGGCCGGCACCAG
CGCGCCACCCTAAAATAAA -> GCGCCACCCTAAAATAAAG
CGCGCGTATCGTGTCCCCG -> GCGCGTATCGTGTCCCCGC
CGCGGCCGACTCTGAACCA -> GCGGCCGACTCTGAACCAT
CGCGGCGAACTCGTCCTTG -> GCGGCGAACTCGTCCTTGG
CGCGTATCGTGTCCCCGCA -> GCGTATCGTGTCCCCGCAC
CGCGTCTCTCGTAAAGCAA -> GCGTCTCTCGTAAAGCAAC
CGCTAAACGGGCGCCCTGT -> GCTAAACGGGCGCCCTGTC
CGCTACATTTACTCTTCCG -> GCTACATTTACTCTTCCGG
CGCTACGAGTAAGCCCGTT -> GCTACGAGTAAGCCCGTTA
CGCTATCCACATCCGATTA -> GCTATCCACATCCGATTAA
CGCTCCAAACTCCTCTTTT -> GCTCCAAACTCCTCTTTTG
CGCTGAAGTGGGGTCTAGC -> GCTGAAGTGGGGTCTAGCA
CGCTTCGTCTTCTTATTTC -> GCTTCGTCTTCTTATTTCC
CGGAAAACGAAAATGGTCA -> GGAAAACGAAAATGGTCAC
CGGAACAAGTTGACGTACG -> GGAACAAGTTGACGTACGC
CGGAAGTGATTGGTGTCGA -> GGAAGTGATTGGTGTCGAC
CGGACTGTGCAAGGACGAT -> GGACTGTGCAAGGACGATC
CGGAGCATTATTAGTAGAA -> GGAGCATTATTAGTAGAAA
CGGATATGGAGAGAATTGG -> GGATATGGAGAGAATTGGA
CGGATCGGGATCTTTTTCT -> GGATCGGGATCTTTTTCTC
CGGATGAGGGACTACGAAC -> GGATGAGGGACTACGAACT
CGGATGGTTAATTCTTCGC -> GGATGGTTAATTCTTCGCG
CGGCACCAGCGTACCGGTG -> GGCACCAGCGTACCGGTGC
CGGCAGACGGTACGGCATA -> GGCAGACGGTACGGCATAC
CGGCAGAGGAAGGGTCTCG -> GGCAGAGGAAGGGTCTCGG
CGGCAGCCGTACTGCGAAG -> GGCAGCCGTACTGCGAAGG
CGGCATACCGTACGACCCC -> GGCATACCGTACGACCCCG
CGGCCGACTCTGAACCATG -> GGCCGACTCTGAACCATGA
CGGCCGTAAGCAACACCTG -> GGCCGTAAGCAACACCTGC
CGGCGAACTCGTCCTTGGC -> GGCGAACTCGTCCTTGGCA
CGGCGACTGTGCAAGGACG -> GGCGACTGTGCAAGGACGA
CGGCGCTGAAGTGGGGTCT -> GGCGCTGAAGTGGGGTCTA
CGGCTAAACGTAACTGAGC -> GGCTAAACGTAACTGAGCT
CGGCTCCTGGCTGGACGTA -> GGCTCCTGGCTGGACGTAC
CGGCTCTCCAGGCGGTCCT -> GGCTCTCCAGGCGGTCCTG
CGGCTGTTCGGCAGAGGAA -> GGCTGTTCGGCAGAGGAAG
CGGCTTGAACTTTTTCTCC -> GGCTTGAACTTTTTCTCCA
CGGCTTTCACGCCTCGGGG -> GGCTTTCACGCCTCGGGGC
CGGGATCGGATCGGGATCT -> GGGATCGGATCGGGATCTT
CGGGATCTTTTTCTCTTTC -> GGGATCTTTTTCTCTTTCG
CGGGCACCGACTTTCGGGT -> GGGCACCGACTTTCGGGTC
CGGGCGCCCTGTCGTGGTG -> GGGCGCCCTGTCGTGGTGG
CGGGCTATTTAACCTCGTC -> GGGCTATTTAACCTCGTCC
CGGGCTCCAGATTCGAATG -> GGGCTCCAGATTCGAATGG
CGGGGCCGGCACCAGCGTA -> GGGGCCGGCACCAGCGTAC
CGGGTCATGCTCCGCCCGT -> GGGTCATGCTCCGCCCGTT
CGGTAAATCAAAATACAGA -> GGTAAATCAAAATACAGAG
CGGTACGGCATACCGTACG -> GGTACGGCATACCGTACGA
CGGTCAAAGATTAGAACCC -> GGTCAAAGATTAGAACCCT
CGGTCCTGACTTTCCATTT -> GGTCCTGACTTTCCATTTA
CGGTCGTATCGATGGGGAA -> GGTCGTATCGATGGGGAAG
CGGTCGTCCACTTTACCTT -> GGTCGTCCACTTTACCTTC
CGGTCTAATCACACAATCC -> GGTCTAATCACACAATCCC
CGGTGCTGCATGATGGGGA -> GGTGCTGCATGATGGGGAA
CGGTTATTAACAAGTCCGG -> GGTTATTAACAAGTCCGGA
CGGTTCGGTCAAAGATTAG -> GGTTCGGTCAAAGATTAGA
CGGTTTACGGACTGTGCAA -> GGTTTACGGACTGTGCAAG
CGTAAAGCAACACCTGCCT -> GTAAAGCAACACCTGCCTA
CGTAACTGAGCTTTTAGTC -> GTAACTGAGCTTTTAGTCA
CGTAAGCAACACCTGCCTA -> GTAAGCAACACCTGCCTAG
CGTACCGGTGCTGCATGAT -> GTACCGGTGCTGCATGATG
CGTACGACCCCGAAAATCT -> GTACGACCCCGAAAATCTC
CGTACGCATCATACACTCC -> GTACGCATCATACACTCCT
CGTACTGCGAAGGGACGTG -> GTACTGCGAAGGGACGTGA
CGTACTGTGTCTAACGGGA -> GTACTGTGTCTAACGGGAT
CGTACTGTTGACAATTTCT -> GTACTGTTGACAATTTCTC
CGTAGAGCTGGCCGCACGC -> GTAGAGCTGGCCGCACGCT
CGTATCGATGGGGAAGCAA -> GTATCGATGGGGAAGCAAC
CGTATCGTGTCCCCGCACG -> GTATCGTGTCCCCGCACGG
CGTATGCCCGGGCTATTTA -> GTATGCCCGGGCTATTTAA
CGTCAGAAATGACTAGGAG -> GTCAGAAATGACTAGGAGA
CGTCCACTTTACCTTCGGA -> GTCCACTTTACCTTCGGAA
CGTCCCCAAGCACTCCCGG -> GTCCCCAAGCACTCCCGGC
CGTCCTTGGCAGCCCGCAT -> GTCCTTGGCAGCCCGCATT
CGTCTCTCGTAAAGCAACA -> GTCTCTCGTAAAGCAACAC
CGTCTTCTTATTTCCTGGT -> GTCTTCTTATTTCCTGGTC
CGTGAAGACTAAGCGCTCC -> GTGAAGACTAAGCGCTCCA
CGTGAAGCCATTATTCCCC -> GTGAAGCCATTATTCCCCG
CGTGCCTTCCGGCAGCCGT -> GTGCCTTCCGGCAGCCGTA
CGTGCTGCATGAACTCGTG -> GTGCTGCATGAACTCGTGC
CGTGGAGGGCGGCTGTTCG -> GTGGAGGGCGGCTGTTCGG
CGTGGTGGGAGAGCTCACT -> GTGGTGGGAGAGCTCACTA
CGTGTCCCCGCACGGATGG -> GTGTCCCCGCACGGATGGT
CGTGTTAACACGCCTATTG -> GTGTTAACACGCCTATTGT
CGTTAATCCACGGTTATTA -> GTTAATCCACGGTTATTAA
CGTTAGAACGGAGCATTAT -> GTTAGAACGGAGCATTATT
CGTTATCTGCTCGCAATCG -> GTTATCTGCTCGCAATCGT
CGTTCCGGCAGACGGTACG -> GTTCCGGCAGACGGTACGG
CGTTCCTAACTAATTGCAA -> GTTCCTAACTAATTGCAAG
CGTTGTGTAGGACAAGCTC -> GTTGTGTAGGACAAGCTCC
CGTTTATAAACAGGGTAGC -> GTTTATAAACAGGGTAGCG
CGTTTTCCGGGCTCCAGAT -> GTTTTCCGGGCTCCAGATT
CTAAAACAGACAAGTGACG -> TAAAACAGACAAGTGACGC
CTAAAATAAAGGGCCTGGT -> TAAAATAAAGGGCCTGGTC
CTAAACGGGCGCCCTGTCG -> TAAACGGGCGCCCTGTCGT
CTAAACGTAACTGAGCTTT -> TAAACGTAACTGAGCTTTT
CTAACATTGGCCCTGTGAC -> TAACATTGGCCCTGTGACC
CTAACGGGATCGGATCGGG -> TAACGGGATCGGATCGGGA
CTAACTAATTGCAAGCAAC -> TAACTAATTGCAAGCAACA
CTAAGCGCTCCAAACTCCT -> TAAGCGCTCCAAACTCCTC
CTAATCACACAATCCCGAC -> TAATCACACAATCCCGACA
CTAATGCCAACTGGTGCAT -> TAATGCCAACTGGTGCATT
CTAATGCCAAGTAGATTAG -> TAATGCCAAGTAGATTAGC
CTAATTGCAAGCAACACCT -> TAATTGCAAGCAACACCTG
CTACATTTACTCTTCCGGC -> TACATTTACTCTTCCGGCC
CTACGAACTGACCTCACCC -> TACGAACTGACCTCACCCT
CTACGAGTAAGCCCGTTAT -> TACGAGTAAGCCCGTTATC
CTACTATATAAAGCTTCCT -> TACTATATAAAGCTTCCTC
CTACTCGGCGCTGAAGTGG -> TACTCGGCGCTGAAGTGGG
CTAGCAGAAGCGCGCCACC -> TAGCAGAAGCGCGCCACCC
CTAGCCCTTGCTTCGAATG -> TAGCCCTTGCTTCGAATGA
CTAGGACCGGTTTACGGAC -> TAGGACCGGTTTACGGACT
CTAGGAGAGAGCTGGGCGA -> TAGGAGAGAGCTGGGCGAA
CTAGGCCTGCTGCGGCGAC -> TAGGCCTGCTGCGGCGACT
CTAGGGCCATGACAGAGAC -> TAGGGCCATGACAGAGACT
CTAGGGGTTTGCAAGCAAA -> TAGGGGTTTGCAAGCAAAT
CTAGGTAATTTTTGTGGAC -> TAGGTAATTTTTGTGGACT
CTATAGCAGCCCCGAGATT -> TATAGCAGCCCCGAGATTG
CTATATAAAGCTTCCTCTG -> TATATAAAGCTTCCTCTGA
CTATATATCCGAGGCAAGG -> TATATATCCGAGGCAAGGC
CTATCCACATCCGATTAAG -> TATCCACATCCGATTAAGA
CTATCCTTTGCATGGAGCT -> TATCCTTTGCATGGAGCTG
CTATCGACGGATGAGGGAC -> TATCGACGGATGAGGGACT
CTATGACTGCACAACGTAT -> TATGACTGCACAACGTATG
CTATTGTCTGATGCCGGAA -> TATTGTCTGATGCCGGAAA
CTATTTAACCTCGTCCCCA -> TATTTAACCTCGTCCCCAA
CTCAATCGCAGCGCACTAA -> TCAATCGCAGCGCACTAAT
CTCACAGTTAGAACGTTCC -> TCACAGTTAGAACGTTCCT
CTCACCCTAGCCCTTGCTT -> TCACCCTAGCCCTTGCTTC
CTCACGTGCTGCATGAACT -> TCACGTGCTGCATGAACTC
CTCACTATATATCCGAGGC -> TCACTATATATCCGAGGCA
CTCCAAACTCCTCTTTTGG -> TCCAAACTCCTCTTTTGGG
CTCCAACAAACCGCATGCG -> TCCAACAAACCGCATGCGG
CTCCACACACTTTGTACCT -> TCCACACACTTTGTACCTT
CTCCAGATTCGAATGGTGA -> TCCAGATTCGAATGGTGAC
CTCCAGCCCTGCCCCCCTT -> TCCAGCCCTGCCCCCCTTT
CTCCAGGCGGTCCTGACTT -> TCCAGGCGGTCCTGACTTT
CTCCCCTTTCACATGCGAA -> TCCCCTTTCACATGCGAAA
CTCCCGGCTCTCCAGGCGG -> TCCCGGCTCTCCAGGCGGT
CTCCCGGCTTGAACTTTTT -> TCCCGGCTTGAACTTTTTC
CTCCCTTGACTACTATATA -> TCCCTTGACTACTATATAA
CTCCGAGGCATCGGAGGCA -> TCCGAGGCATCGGAGGCAA
CTCCGCCCGTTTTCCGGGC -> TCCGCCCGTTTTCCGGGCT
CTCCGTGAAGCCATTATTC -> TCCGTGAAGCCATTATTCC
CTCCTATGACTGCACAACG -> TCCTATGACTGCACAACGT
CTCCTCTTTTGGGTCGTAG -> TCCTCTTTTGGGTCGTAGA
CTCCTGGCTGGACGTACTG -> TCCTGGCTGGACGTACTGT
CTCGAACCCACGCGGCCGA -> TCGAACCCACGCGGCCGAC
CTCGATTTTCTAATGCCAA -> TCGATTTTCTAATGCCAAG
CTCGCAATCGTACTGTGTC -> TCGCAATCGTACTGTGTCT
CTCGGCGCTGAAGTGGGGT -> TCGGCGCTGAAGTGGGGTC
CTCGGGCACCGACTTTCGG -> TCGGGCACCGACTTTCGGG
CTCGGGGCCGGCACCAGCG -> TCGGGGCCGGCACCAGCGT
CTCGTAAAGCAACACCTGC -> TCGTAAAGCAACACCTGCC
CTCGTCAGAAATGACTAGG -> TCGTCAGAAATGACTAGGA
CTCGTCCCCAAGCACTCCC -> TCGTCCCCAAGCACTCCCG
CTCGTCCTTGGCAGCCCGC -> TCGTCCTTGGCAGCCCGCA
CTCGTGCCTTCCGGCAGCC -> TCGTGCCTTCCGGCAGCCG
CTCTAACATTGGCCCTGTG -> TCTAACATTGGCCCTGTGA
CTCTCCAGGCGGTCCTGAC -> TCTCCAGGCGGTCCTGACT
CTCTCGTAAAGCAACACCT -> TCTCGTAAAGCAACACCTG
CTCTGAAAAGTGCCGAGAT -> TCTGAAAAGTGCCGAGATG
CTCTGAACCATGACATTCG -> TCTGAACCATGACATTCGG
CTCTTATGGGACGGTTCGG -> TCTTATGGGACGGTTCGGT
CTCTTATTATTCATAGACT -> TCTTATTATTCATAGACTG
CTCTTCCGGCCGTAAGCAA -> TCTTCCGGCCGTAAGCAAC
CTCTTTCGCATACAGATAC -> TCTTTCGCATACAGATACC
CTCTTTTGGGTCGTAGAGC -> TCTTTTGGGTCGTAGAGCT
CTGAAAAGTGCCGAGATGC -> TGAAAAGTGCCGAGATGCT
CTGAACCATGACATTCGGC -> TGAACCATGACATTCGGCT
CTGAAGTGGGGTCTAGCAG -> TGAAGTGGGGTCTAGCAGA
CTGACCTCACCCTAGCCCT -> TGACCTCACCCTAGCCCTT
CTGACTTTCCATTTAGATA -> TGACTTTCCATTTAGATAT
CTGAGCCTGGGGATTAGCG -> TGAGCCTGGGGATTAGCGA
CTGAGCTTTTAGTCAGGGA -> TGAGCTTTTAGTCAGGGAG
CTGATGCCGGAAAACGAAA -> TGATGCCGGAAAACGAAAA
CTGCACAACGTATGCCCGG -> TGCACAACGTATGCCCGGG
CTGCAGACGCGTCTCTCGT -> TGCAGACGCGTCTCTCGTA
CTGCATGAACTCGTGCCTT -> TGCATGAACTCGTGCCTTC
CTGCATGATGGGGAATGCC -> TGCATGATGGGGAATGCCG
CTGCCCCCCTTTTAGTGAT -> TGCCCCCCTTTTAGTGATG
CTGCCCTTACTCGATTTTC -> TGCCCTTACTCGATTTTCT
CTGCCTAGGACCGGTTTAC -> TGCCTAGGACCGGTTTACG
CTGCCTAGGCCTGCTGCGG -> TGCCTAGGCCTGCTGCGGC
CTGCCTAGGGCCATGACAG -> TGCCTAGGGCCATGACAGA
CTGCCTAGGTAATTTTTGT -> TGCCTAGGTAATTTTTGTG
CTGCGAAGGGACGTGAAGA -> TGCGAAGGGACGTGAAGAC
CTGCGGCGACTGTGCAAGG -> TGCGGCGACTGTGCAAGGA
CTGCGGCTAAACGTAACTG -> TGCGGCTAAACGTAACTGA
CTGCTAAAACAGACAAGTG -> TGCTAAAACAGACAAGTGA
CTGCTCGCAATCGTACTGT -> TGCTCGCAATCGTACTGTG
CTGCTGCGGCGACTGTGCA -> TGCTGCGGCGACTGTGCAA
CTGGACGTACTGTTGACAA -> TGGACGTACTGTTGACAAT
CTGGCCGCACGCTACATTT -> TGGCCGCACGCTACATTTA
CTGGCTATCCTTTGCATGG -> TGGCTATCCTTTGCATGGA
CTGGCTGGACGTACTGTTG -> TGGCTGGACGTACTGTTGA
CTGGGCGAAATGAGTCTCG -> TGGGCGAAATGAGTCTCGA
CTGGGGATTAGCGAGTGGG -> TGGGGATTAGCGAGTGGGT
CTGGTCCGTTCCGGCAGAC -> TGGTCCGTTCCGGCAGACG
CTGGTCTGCCCTTACTCGA -> TGGTCTGCCCTTACTCGAT
CTGGTGCATTTGTTTAGTA -> TGGTGCATTTGTTTAGTAA
CTGTCGATTTCCTGCTAAA -> TGTCGATTTCCTGCTAAAA
CTGTCGGTCGTCCACTTTA -> TGTCGGTCGTCCACTTTAC
CTGTCGTGGTGGGAGAGCT -> TGTCGTGGTGGGAGAGCTC
CTGTGACCACTTAGTTACA -> TGTGACCACTTAGTTACAC
CTGTGCAAGGACGATCCAG -> TGTGCAAGGACGATCCAGA
CTGTGCAAGGACGATCCCG -> TGTGCAAGGACGATCCCGT,TGTGCAAGGACGATCCCGT
CTGTGCAAGGACGATCCGC -> TGTGCAAGGACGATCCGCT
CTGTGTCTAACGGGATCGG -> TGTGTCTAACGGGATCGGA
CTGTTACTACTCGGCGCTG -> TGTTACTACTCGGCGCTGA
CTGTTCGGCAGAGGAAGGG -> TGTTCGGCAGAGGAAGGGT
CTGTTGACAATTTCTCTTA -> TGTTGACAATTTCTCTTAT
CTTAACCACGCGCGTATCG -> TTAACCACGCGCGTATCGT
CTTAATGCGACTTTTCCTA -> TTAATGCGACTTTTCCTAT
CTTACTCGATTTTCTAATG -> TTACTCGATTTTCTAATGC
CTTAGTTACACATCGACTC -> TTAGTTACACATCGACTCC
CTTATATTCTTAACCACGC -> TTATATTCTTAACCACGCG
CTTATGGGACGGTTCGGTC -> TTATGGGACGGTTCGGTCA
CTTATTATTCATAGACTGG -> TTATTATTCATAGACTGGC
CTTATTTCCTGGTCTGCCC -> TTATTTCCTGGTCTGCCCT
CTTCAGAAACGGAAGTGAT -> TTCAGAAACGGAAGTGATT
CTTCCGGCAGCCGTACTGC -> TTCCGGCAGCCGTACTGCG
CTTCCGGCCGTAAGCAACA -> TTCCGGCCGTAAGCAACAC
CTTCCTCTGAAAAGTGCCG -> TTCCTCTGAAAAGTGCCGA
CTTCGAATGAGACAGAGAG -> TTCGAATGAGACAGAGAGG
CTTCGCGGCGAACTCGTCC -> TTCGCGGCGAACTCGTCCT
CTTCGGAACAAGTTGACGT -> TTCGGAACAAGTTGACGTA
CTTCGTCTTCTTATTTCCT -> TTCGTCTTCTTATTTCCTG
CTTCTGCGGCTAAACGTAA -> TTCTGCGGCTAAACGTAAC
CTTCTTATTTCCTGGTCTG -> TTCTTATTTCCTGGTCTGC
CTTGAACTTTTTCTCCAGC -> TTGAACTTTTTCTCCAGCC
CTTGAAGCCAACCACAGCT -> TTGAAGCCAACCACAGCTC
CTTGACTACTATATAAAGC -> TTGACTACTATATAAAGCT
CTTGCTTCGAATGAGACAG -> TTGCTTCGAATGAGACAGA
CTTGGCAGCCCGCATTCAC -> TTGGCAGCCCGCATTCACC
CTTGTTCGCCGTGTTAACA -> TTGTTCGCCGTGTTAACAC
CTTTACCTTCGGAACAAGT -> TTTACCTTCGGAACAAGTT
CTTTCACATGCGAAAGAAG -> TTTCACATGCGAAAGAAGA
CTTTCACGCCTCGGGGCCG -> TTTCACGCCTCGGGGCCGG
CTTTCCATTTAGATATGAG -> TTTCCATTTAGATATGAGT
CTTTCGCATACAGATACCT -> TTTCGCATACAGATACCTC
CTTTCGGGTCATGCTCCGC -> TTTCGGGTCATGCTCCGCC
CTTTGCATGGAGCTGAGCC -> TTTGCATGGAGCTGAGCCT
CTTTGTACCTTTTACTTGT -> TTTGTACCTTTTACTTGTT
CTTTTACTTGTTCGCCGTG -> TTTTACTTGTTCGCCGTGT
CTTTTAGACAACCCTTCAG -> TTTTAGACAACCCTTCAGA
CTTTTAGTCAGGGAGGGCG -> TTTTAGTCAGGGAGGGCGC
CTTTTAGTGATGCCTCGTC -> TTTTAGTGATGCCTCGTCA
CTTTTCCTATCGACGGATG -> TTTTCCTATCGACGGATGA
CTTTTGGGTCGTAGAGCTG -> TTTTGGGTCGTAGAGCTGG
CTTTTTCTCCAGCCCTGCC -> TTTTTCTCCAGCCCTGCCC
CTTTTTCTCTTTCGCATAC -> TTTTTCTCTTTCGCATACA
GAAAACGAAAATGGTCACT -> AAAACGAAAATGGTCACTC
GAAAAGTGCCGAGATGCTA -> AAAAGTGCCGAGATGCTAT
GAAAATCTCCGAGGCATCG -> AAAATCTCCGAGGCATCGG
GAAAATGGTCACTCTAACA -> AAAATGGTCACTCTAACAT
GAAACGGAAGTGATTGGTG -> AAACGGAAGTGATTGGTGT
GAAAGAAGATTTGCCGGTC -> AAAGAAGATTTGCCGGTCT
GAAATGACTAGGAGAGAGC -> AAATGACTAGGAGAGAGCT
GAAATGAGTCTCGAACCCA -> AAATGAGTCTCGAACCCAC
GAAATTGACAGGAGGCGCC -> AAATTGACAGGAGGCGCCC
GAACAAGTTGACGTACGCA -> AACAAGTTGACGTACGCAT
GAACCATGACATTCGGCTC -> AACCATGACATTCGGCTCC
GAACCCACGCGGCCGACTC -> AACCCACGCGGCCGACTCT
GAACCCTTCTGCGGCTAAA -> AACCCTTCTGCGGCTAAAC
GAACGGAGCATTATTAGTA -> AACGGAGCATTATTAGTAG
GAACGTTCCTAACTAATTG -> AACGTTCCTAACTAATTGC
GAACTCGTCCTTGGCAGCC -> AACTCGTCCTTGGCAGCCC
GAACTCGTGCCTTCCGGCA -> AACTCGTGCCTTCCGGCAG
GAACTGACCTCACCCTAGC -> AACTGACCTCACCCTAGCC
GAACTTTTTCTCCAGCCCT -> AACTTTTTCTCCAGCCCTG
GAAGACTAAGCGCTCCAAA -> AAGACTAAGCGCTCCAAAC
GAAGATTTGCCGGTCTAAT -> AAGATTTGCCGGTCTAATC
GAAGCAACACCTGCCTAGG -> AAGCAACACCTGCCTAGGG
GAAGCCAACCACAGCTCCC -> AAGCCAACCACAGCTCCCT
GAAGCCATTATTCCCCGAT -> AAGCCATTATTCCCCGATC
GAAGCGCGCCACCCTAAAA -> AAGCGCGCCACCCTAAAAT
GAAGGGACGTGAAGACTAA -> AAGGGACGTGAAGACTAAG
GAAGGGTCTCGGGCACCGA -> AAGGGTCTCGGGCACCGAC
GAAGTGATTGGTGTCGACC -> AAGTGATTGGTGTCGACCA
GAAGTGGGGTCTAGCAGAA -> AAGTGGGGTCTAGCAGAAG
GAATGAGACAGAGAGGTGT -> AATGAGACAGAGAGGTGTA
GAATGCCGCATGTCGAGGG -> AATGCCGCATGTCGAGGGC
GAATGCCTCACAGTTAGAA -> AATGCCTCACAGTTAGAAC
GAATGGTGACGACTGCAGA -> AATGGTGACGACTGCAGAC
GAATTGGACTTATATTCTT -> AATTGGACTTATATTCTTA
GACAACCCTTCAGAAACGG -> ACAACCCTTCAGAAACGGA
GACAAGCTCCACACACTTT -> ACAAGCTCCACACACTTTG
GACAAGTGACGCTATCCAC -> ACAAGTGACGCTATCCACA
GACAATTTCTCTTATGGGA -> ACAATTTCTCTTATGGGAC
GACAGAGACTGTGCAAGGA -> ACAGAGACTGTGCAAGGAC
GACAGAGAGGTGTACGCAC -> ACAGAGAGGTGTACGCACT
GACAGGAGGCGCCCGGCTT -> ACAGGAGGCGCCCGGCTTT
GACAGGCTTAATGCGACTT -> ACAGGCTTAATGCGACTTT
GACAGGTATTGGGATCATG -> ACAGGTATTGGGATCATGT
GACATTCGGCTCCTGGCTG -> ACATTCGGCTCCTGGCTGG
GACCAACGCCATTACGACG -> ACCAACGCCATTACGACGG
GACCACTTAGTTACACATC -> ACCACTTAGTTACACATCG
GACCCCGAAAATCTCCGAG -> ACCCCGAAAATCTCCGAGG
GACCGGTTTACGGACTGTG -> ACCGGTTTACGGACTGTGC
GACCTCACCCTAGCCCTTG -> ACCTCACCCTAGCCCTTGC
GACGACTGCAGACGCGTCT -> ACGACTGCAGACGCGTCTC
GACGATCCAGACTGTCGAT -> ACGATCCAGACTGTCGATT
GACGATCCCGTGGAGGGCG -> ACGATCCCGTGGAGGGCGG
GACGATCCCGTTAATCCAC -> ACGATCCCGTTAATCCACG
GACGATCCGCTAAACGGGC -> ACGATCCGCTAAACGGGCG
GACGCGTCTCTCGTAAAGC -> ACGCGTCTCTCGTAAAGCA
GACGCTATCCACATCCGAT -> ACGCTATCCACATCCGATT
GACGGATGAGGGACTACGA -> ACGGATGAGGGACTACGAA
GACGGTAAATCAAAATACA -> ACGGTAAATCAAAATACAG
GACGGTACGGCATACCGTA -> ACGGTACGGCATACCGTAC
GACGGTTCGGTCAAAGATT -> ACGGTTCGGTCAAAGATTA
GACGTACGCATCATACACT -> ACGTACGCATCATACACTC
GACGTACTGTTGACAATTT -> ACGTACTGTTGACAATTTC
GACGTGAAGACTAAGCGCT -> ACGTGAAGACTAAGCGCTC
GACTAAGCGCTCCAAACTC -> ACTAAGCGCTCCAAACTCC
GACTACGAACTGACCTCAC -> ACTACGAACTGACCTCACC
GACTACTATATAAAGCTTC -> ACTACTATATAAAGCTTCC
GACTAGGAGAGAGCTGGGC -> ACTAGGAGAGAGCTGGGCG
GACTCCCGGCTCTCCAGGC -> ACTCCCGGCTCTCCAGGCG
GACTCTGAACCATGACATT -> ACTCTGAACCATGACATTC
GACTGCACAACGTATGCCC -> ACTGCACAACGTATGCCCG
GACTGCAGACGCGTCTCTC -> ACTGCAGACGCGTCTCTCG
GACTGGCTATCCTTTGCAT -> ACTGGCTATCCTTTGCATG
GACTGTCGATTTCCTGCTA -> ACTGTCGATTTCCTGCTAA
GACTGTGCAAGGACGATCC -> ACTGTGCAAGGACGATCCA,ACTGTGCAAGGACGATCCC,ACTGTGCAAGGACGATCCC,ACTGTGCAAGGACGATCCG
GACTTATATTCTTAACCAC -> ACTTATATTCTTAACCACG
GACTTGAAGCCAACCACAG -> ACTTGAAGCCAACCACAGC
GACTTTCCATTTAGATATG -> ACTTTCCATTTAGATATGA
GACTTTCGGGTCATGCTCC -> ACTTTCGGGTCATGCTCCG
GACTTTTCCTATCGACGGA -> ACTTTTCCTATCGACGGAT
GAGAATTGGACTTATATTC -> AGAATTGGACTTATATTCT
GAGACAGAGAGGTGTACGC -> AGACAGAGAGGTGTACGCA
GAGACTGTGCAAGGACGAT -> AGACTGTGCAAGGACGATC
GAGAGAATTGGACTTATAT -> AGAGAATTGGACTTATATT
GAGAGAGCTGGGCGAAATG -> AGAGAGCTGGGCGAAATGA
GAGAGCTCACTATATATCC -> AGAGCTCACTATATATCCG
GAGAGCTGGGCGAAATGAG -> AGAGCTGGGCGAAATGAGT
GAGAGGTGTACGCACTCCG -> AGAGGTGTACGCACTCCGT
GAGATGCTATAGCAGCCCC -> AGATGCTATAGCAGCCCCG
GAGATTGTATAATCTTTTA -> AGATTGTATAATCTTTTAG
GAGCATTATTAGTAGAAAT -> AGCATTATTAGTAGAAATT
GAGCCTGGGGATTAGCGAG -> AGCCTGGGGATTAGCGAGT
GAGCTCACTATATATCCGA -> AGCTCACTATATATCCGAG
GAGCTGAGCCTGGGGATTA -> AGCTGAGCCTGGGGATTAG
GAGCTGGCCGCACGCTACA -> AGCTGGCCGCACGCTACAT
GAGCTGGGCGAAATGAGTC -> AGCTGGGCGAAATGAGTCT
GAGCTTTTAGTCAGGGAGG -> AGCTTTTAGTCAGGGAGGG
GAGGAAGGGTCTCGGGCAC -> AGGAAGGGTCTCGGGCACC
GAGGCAAGGCGTTGTGTAG -> AGGCAAGGCGTTGTGTAGG
GAGGCGCCCGGCTTTCACG -> AGGCGCCCGGCTTTCACGC
GAGGGACTACGAACTGACC -> AGGGACTACGAACTGACCT
GAGGGCGCTACGAGTAAGC -> AGGGCGCTACGAGTAAGCC
GAGGGCGGCTGTTCGGCAG -> AGGGCGGCTGTTCGGCAGA
GAGGGCTGTCGGTCGTCCA -> AGGGCTGTCGGTCGTCCAC
GAGGTGTACGCACTCCGTG -> AGGTGTACGCACTCCGTGA
GAGTAAGACAGGCTTAATG -> AGTAAGACAGGCTTAATGC
GAGTAAGCCCGTTATCTGC -> AGTAAGCCCGTTATCTGCT
GAGTCTCGAACCCACGCGG -> AGTCTCGAACCCACGCGGC
GAGTGGGTATCCAAATGTG -> AGTGGGTATCCAAATGTGA
GAGTTTGCATTCTCCAACA -> AGTTTGCATTCTCCAACAA
GATACCTCCCCTTTCACAT -> ATACCTCCCCTTTCACATG
GATATGAGTTTGCATTCTC -> ATATGAGTTTGCATTCTCC
GATATGGAGAGAATTGGAC -> ATATGGAGAGAATTGGACT
GATCATGTATAACTAGGGG -> ATCATGTATAACTAGGGGT
GATCCAGACTGTCGATTTC -> ATCCAGACTGTCGATTTCC
GATCCCGTGGAGGGCGGCT -> ATCCCGTGGAGGGCGGCTG
GATCCCGTTAATCCACGGT -> ATCCCGTTAATCCACGGTT
GATCCGCTAAACGGGCGCC -> ATCCGCTAAACGGGCGCCC
GATCCGTTAGAACGGAGCA -> ATCCGTTAGAACGGAGCAT
GATCGGATCGGGATCTTTT -> ATCGGATCGGGATCTTTTT
GATCGGGATCTTTTTCTCT -> ATCGGGATCTTTTTCTCTT
GATCGTTTATAAACAGGGT -> ATCGTTTATAAACAGGGTA
GATCTTTTTCTCTTTCGCA -> ATCTTTTTCTCTTTCGCAT
GATGAGGGACTACGAACTG -> ATGAGGGACTACGAACTGA
GATGCCGGAAAACGAAAAT -> ATGCCGGAAAACGAAAATG
GATGCCTCGTCAGAAATGA -> ATGCCTCGTCAGAAATGAC
GATGCTATAGCAGCCCCGA -> ATGCTATAGCAGCCCCGAG
GATGGGGAAGCAACACCTG -> ATGGGGAAGCAACACCTGC
GATGGGGAATGCCGCATGT -> ATGGGGAATGCCGCATGTC
GATGGTTAATTCTTCGCGG -> ATGGTTAATTCTTCGCGGC
GATTAAGACTTGAAGCCAA -> ATTAAGACTTGAAGCCAAC
GATTAGAACCCTTCTGCGG -> ATTAGAACCCTTCTGCGGC
GATTAGCGAGTGGGTATCC -> ATTAGCGAGTGGGTATCCA
GATTAGCTCACGTGCTGCA -> ATTAGCTCACGTGCTGCAT
GATTCGAATGGTGACGACT -> ATTCGAATGGTGACGACTG
GATTGGTGTCGACCAACGC -> ATTGGTGTCGACCAACGCC
GATTGTATAATCTTTTAGA -> ATTGTATAATCTTTTAGAC
GATTTCCTGCTAAAACAGA -> ATTTCCTGCTAAAACAGAC
GATTTGCCGGTCTAATCAC -> ATTTGCCGGTCTAATCACA
GATTTTCTAATGCCAAGTA -> ATTTTCTAATGCCAAGTAG
GCAAATTTAATGGAATGCC -> CAAATTTAATGGAATGCCT
GCAACACCTGCCTAGGACC -> CAACACCTGCCTAGGACCG
GCAACACCTGCCTAGGCCT -> CAACACCTGCCTAGGCCTG
GCAACACCTGCCTAGGGCC -> CAACACCTGCCTAGGGCCA
GCAACACCTGCCTAGGTAA -> CAACACCTGCCTAGGTAAT
GCAAGCAAATTTAATGGAA -> CAAGCAAATTTAATGGAAT
GCAAGCAACACCTGCCTAG -> CAAGCAACACCTGCCTAGG
GCAAGGACGATCCAGACTG -> CAAGGACGATCCAGACTGT
GCAAGGACGATCCCGTGGA -> CAAGGACGATCCCGTGGAG
GCAAGGACGATCCCGTTAA -> CAAGGACGATCCCGTTAAT
GCAAGGACGATCCGCTAAA -> CAAGGACGATCCGCTAAAC
GCAAGGCGTTGTGTAGGAC -> CAAGGCGTTGTGTAGGACA
GCAATCGTACTGTGTCTAA -> CAATCGTACTGTGTCTAAC
GCACAACGTATGCCCGGGC -> CACAACGTATGCCCGGGCT
GCACCAGCGTACCGGTGCT -> CACCAGCGTACCGGTGCTG
GCACCGACTTTCGGGTCAT -> CACCGACTTTCGGGTCATG
GCACGCTACATTTACTCTT -> CACGCTACATTTACTCTTC
GCACGGATGGTTAATTCTT -> CACGGATGGTTAATTCTTC
GCACTAATGCCAACTGGTG -> CACTAATGCCAACTGGTGC
GCACTCCCGGCTTGAACTT -> CACTCCCGGCTTGAACTTT
GCACTCCGTGAAGCCATTA -> CACTCCGTGAAGCCATTAT
GCAGAAGCGCGCCACCCTA -> CAGAAGCGCGCCACCCTAA
GCAGACGCGTCTCTCGTAA -> CAGACGCGTCTCTCGTAAA
GCAGACGGTACGGCATACC -> CAGACGGTACGGCATACCG
GCAGAGGAAGGGTCTCGGG -> CAGAGGAAGGGTCTCGGGC
GCAGCCCCGAGATTGTATA -> CAGCCCCGAGATTGTATAA
GCAGCCCGCATTCACCTCA -> CAGCCCGCATTCACCTCAA
GCAGCCGTACTGCGAAGGG -> CAGCCGTACTGCGAAGGGA
GCAGCGCACTAATGCCAAC -> CAGCGCACTAATGCCAACT
GCATACAGATACCTCCCCT -> CATACAGATACCTCCCCTT
GCATACCGTACGACCCCGA -> CATACCGTACGACCCCGAA
GCATCATACACTCCTATGA -> CATCATACACTCCTATGAC
GCATGAACTCGTGCCTTCC -> CATGAACTCGTGCCTTCCG
GCATGATGGGGAATGCCGC -> CATGATGGGGAATGCCGCA
GCATGCGGTCGTATCGATG -> CATGCGGTCGTATCGATGG
GCATGGAGCTGAGCCTGGG -> CATGGAGCTGAGCCTGGGG
GCATGTCGAGGGCTGTCGG -> CATGTCGAGGGCTGTCGGT
GCATTATTAGTAGAAATTG -> CATTATTAGTAGAAATTGA
GCATTCACCTCAATCGCAG -> CATTCACCTCAATCGCAGC
GCATTCTCCAACAAACCGC -> CATTCTCCAACAAACCGCA
GCATTTGTTTAGTAAGCCC -> CATTTGTTTAGTAAGCCCT
GCCAACCACAGCTCCCTTG -> CCAACCACAGCTCCCTTGA
GCCAACTGGTGCATTTGTT -> CCAACTGGTGCATTTGTTT
GCCAAGTAGATTAGCTCAC -> CCAAGTAGATTAGCTCACG
GCCACCCTAAAATAAAGGG -> CCACCCTAAAATAAAGGGC
GCCATGACAGAGACTGTGC -> CCATGACAGAGACTGTGCA
GCCATTACGACGGTAAATC -> CCATTACGACGGTAAATCA
GCCATTATTCCCCGATCGT -> CCATTATTCCCCGATCGTT
GCCCCCCTTTTAGTGATGC -> CCCCCCTTTTAGTGATGCC
GCCCCGAGATTGTATAATC -> CCCCGAGATTGTATAATCT
GCCCGCATTCACCTCAATC -> CCCGCATTCACCTCAATCG
GCCCGGCTTTCACGCCTCG -> CCCGGCTTTCACGCCTCGG
GCCCGGGCTATTTAACCTC -> CCCGGGCTATTTAACCTCG
GCCCGTTATCTGCTCGCAA -> CCCGTTATCTGCTCGCAAT
GCCCGTTTTCCGGGCTCCA -> CCCGTTTTCCGGGCTCCAG
GCCCTGCCCCCCTTTTAGT -> CCCTGCCCCCCTTTTAGTG
GCCCTGTCGTGGTGGGAGA -> CCCTGTCGTGGTGGGAGAG
GCCCTGTGACCACTTAGTT -> CCCTGTGACCACTTAGTTA
GCCCTGTTACTACTCGGCG -> CCCTGTTACTACTCGGCGC
GCCCTTACTCGATTTTCTA -> CCCTTACTCGATTTTCTAA
GCCCTTGCTTCGAATGAGA -> CCCTTGCTTCGAATGAGAC
GCCGACTCTGAACCATGAC -> CCGACTCTGAACCATGACA
GCCGAGATGCTATAGCAGC -> CCGAGATGCTATAGCAGCC
GCCGCACGCTACATTTACT -> CCGCACGCTACATTTACTC
GCCGCATGTCGAGGGCTGT -> CCGCATGTCGAGGGCTGTC
GCCGGAAAACGAAAATGGT -> CCGGAAAACGAAAATGGTC
GCCGGCACCAGCGTACCGG -> CCGGCACCAGCGTACCGGT
GCCGGTCTAATCACACAAT -> CCGGTCTAATCACACAATC
GCCGTAAGCAACACCTGCC -> CCGTAAGCAACACCTGCCT
GCCGTACTGCGAAGGGACG -> CCGTACTGCGAAGGGACGT
GCCGTGTTAACACGCCTAT -> CCGTGTTAACACGCCTATT
GCCTAGGACCGGTTTACGG -> CCTAGGACCGGTTTACGGA
GCCTAGGCCTGCTGCGGCG -> CCTAGGCCTGCTGCGGCGA
GCCTAGGGCCATGACAGAG -> CCTAGGGCCATGACAGAGA
GCCTAGGTAATTTTTGTGG -> CCTAGGTAATTTTTGTGGA
GCCTATTGTCTGATGCCGG -> CCTATTGTCTGATGCCGGA
GCCTCACAGTTAGAACGTT -> CCTCACAGTTAGAACGTTC
GCCTCGGGGCCGGCACCAG -> CCTCGGGGCCGGCACCAGC
GCCTCGTCAGAAATGACTA -> CCTCGTCAGAAATGACTAG
GCCTGCTGCGGCGACTGTG -> CCTGCTGCGGCGACTGTGC
GCCTGGGGATTAGCGAGTG -> CCTGGGGATTAGCGAGTGG
GCCTGGTCCGTTCCGGCAG -> CCTGGTCCGTTCCGGCAGA
GCCTTCCGGCAGCCGTACT -> CCTTCCGGCAGCCGTACTG
GCGAAAGAAGATTTGCCGG -> CGAAAGAAGATTTGCCGGT
GCGAAATGAGTCTCGAACC -> CGAAATGAGTCTCGAACCC
GCGAACTCGTCCTTGGCAG -> CGAACTCGTCCTTGGCAGC
GCGAAGGGACGTGAAGACT -> CGAAGGGACGTGAAGACTA
GCGACTGTGCAAGGACGAT -> CGACTGTGCAAGGACGATC
GCGACTTTTCCTATCGACG -> CGACTTTTCCTATCGACGG
GCGAGTGGGTATCCAAATG -> CGAGTGGGTATCCAAATGT
GCGCACTAATGCCAACTGG -> CGCACTAATGCCAACTGGT
GCGCCACCCTAAAATAAAG -> CGCCACCCTAAAATAAAGG
GCGCCCGGCTTTCACGCCT -> CGCCCGGCTTTCACGCCTC
GCGCCCTGTCGTGGTGGGA -> CGCCCTGTCGTGGTGGGAG
GCGCGCCACCCTAAAATAA -> CGCGCCACCCTAAAATAAA
GCGCGTATCGTGTCCCCGC -> CGCGTATCGTGTCCCCGCA
GCGCTACGAGTAAGCCCGT -> CGCTACGAGTAAGCCCGTT
GCGCTCCAAACTCCTCTTT -> CGCTCCAAACTCCTCTTTT
GCGCTGAAGTGGGGTCTAG -> CGCTGAAGTGGGGTCTAGC
GCGCTTCGTCTTCTTATTT -> CGCTTCGTCTTCTTATTTC
GCGGCCGACTCTGAACCAT -> CGGCCGACTCTGAACCATG
GCGGCGAACTCGTCCTTGG -> CGGCGAACTCGTCCTTGGC
GCGGCGACTGTGCAAGGAC -> CGGCGACTGTGCAAGGACG
GCGGCTAAACGTAACTGAG -> CGGCTAAACGTAACTGAGC
GCGGCTGTTCGGCAGAGGA -> CGGCTGTTCGGCAGAGGAA
GCGGTCCTGACTTTCCATT -> CGGTCCTGACTTTCCATTT
GCGGTCGTATCGATGGGGA -> CGGTCGTATCGATGGGGAA
GCGTACCGGTGCTGCATGA -> CGTACCGGTGCTGCATGAT
GCGTATCGTGTCCCCGCAC -> CGTATCGTGTCCCCGCACG
GCGTCTCTCGTAAAGCAAC -> CGTCTCTCGTAAAGCAACA
GCGTTGTGTAGGACAAGCT -> CGTTGTGTAGGACAAGCTC
GCTAAAACAGACAAGTGAC -> CTAAAACAGACAAGTGACG
GCTAAACGGGCGCCCTGTC -> CTAAACGGGCGCCCTGTCG
GCTAAACGTAACTGAGCTT -> CTAAACGTAACTGAGCTTT
GCTACATTTACTCTTCCGG -> CTACATTTACTCTTCCGGC
GCTACGAGTAAGCCCGTTA -> CTACGAGTAAGCCCGTTAT
GCTATAGCAGCCCCGAGAT -> CTATAGCAGCCCCGAGATT
GCTATCCACATCCGATTAA -> CTATCCACATCCGATTAAG
GCTATCCTTTGCATGGAGC -> CTATCCTTTGCATGGAGCT
GCTATTTAACCTCGTCCCC -> CTATTTAACCTCGTCCCCA
GCTCACGTGCTGCATGAAC -> CTCACGTGCTGCATGAACT
GCTCACTATATATCCGAGG -> CTCACTATATATCCGAGGC
GCTCCAAACTCCTCTTTTG -> CTCCAAACTCCTCTTTTGG
GCTCCACACACTTTGTACC -> CTCCACACACTTTGTACCT
GCTCCAGATTCGAATGGTG -> CTCCAGATTCGAATGGTGA
GCTCCCTTGACTACTATAT -> CTCCCTTGACTACTATATA
GCTCCGCCCGTTTTCCGGG -> CTCCGCCCGTTTTCCGGGC
GCTCCTGGCTGGACGTACT -> CTCCTGGCTGGACGTACTG
GCTCGCAATCGTACTGTGT -> CTCGCAATCGTACTGTGTC
GCTCTCCAGGCGGTCCTGA -> CTCTCCAGGCGGTCCTGAC
GCTGAAGTGGGGTCTAGCA -> CTGAAGTGGGGTCTAGCAG
GCTGAGCCTGGGGATTAGC -> CTGAGCCTGGGGATTAGCG
GCTGCATGAACTCGTGCCT -> CTGCATGAACTCGTGCCTT
GCTGCATGATGGGGAATGC -> CTGCATGATGGGGAATGCC
GCTGCGGCGACTGTGCAAG -> CTGCGGCGACTGTGCAAGG
GCTGGACGTACTGTTGACA -> CTGGACGTACTGTTGACAA
GCTGGCCGCACGCTACATT -> CTGGCCGCACGCTACATTT
GCTGGGCGAAATGAGTCTC -> CTGGGCGAAATGAGTCTCG
GCTGTCGGTCGTCCACTTT -> CTGTCGGTCGTCCACTTTA
GCTGTTCGGCAGAGGAAGG -> CTGTTCGGCAGAGGAAGGG
GCTTAATGCGACTTTTCCT -> CTTAATGCGACTTTTCCTA
GCTTCCTCTGAAAAGTGCC -> CTTCCTCTGAAAAGTGCCG
GCTTCGAATGAGACAGAGA -> CTTCGAATGAGACAGAGAG
GCTTCGTCTTCTTATTTCC -> CTTCGTCTTCTTATTTCCT
GCTTGAACTTTTTCTCCAG -> CTTGAACTTTTTCTCCAGC
GCTTTCACGCCTCGGGGCC -> CTTTCACGCCTCGGGGCCG
GCTTTTAGTCAGGGAGGGC -> CTTTTAGTCAGGGAGGGCG
GGAAAACGAAAATGGTCAC -> GAAAACGAAAATGGTCACT
GGAACAAGTTGACGTACGC -> GAACAAGTTGACGTACGCA
GGAAGCAACACCTGCCTAG -> GAAGCAACACCTGCCTAGG
GGAAGGGTCTCGGGCACCG -> GAAGGGTCTCGGGCACCGA
GGAAGTGATTGGTGTCGAC -> GAAGTGATTGGTGTCGACC
GGAATGCCGCATGTCGAGG -> GAATGCCGCATGTCGAGGG
GGAATGCCTCACAGTTAGA -> GAATGCCTCACAGTTAGAA
GGACAAGCTCCACACACTT -> GACAAGCTCCACACACTTT
GGACCGGTTTACGGACTGT -> GACCGGTTTACGGACTGTG
GGACGATCCAGACTGTCGA -> GACGATCCAGACTGTCGAT
GGACGATCCCGTGGAGGGC -> GACGATCCCGTGGAGGGCG
GGACGATCCCGTTAATCCA -> GACGATCCCGTTAATCCAC
GGACGATCCGCTAAACGGG -> GACGATCCGCTAAACGGGC
GGACGGTTCGGTCAAAGAT -> GACGGTTCGGTCAAAGATT
GGACGTACTGTTGACAATT -> GACGTACTGTTGACAATTT
GGACGTGAAGACTAAGCGC -> GACGTGAAGACTAAGCGCT
GGACTACGAACTGACCTCA -> GACTACGAACTGACCTCAC
GGACTGTGCAAGGACGATC -> GACTGTGCAAGGACGATCC,GACTGTGCAAGGACGATCC
GGACTTATATTCTTAACCA -> GACTTATATTCTTAACCAC
GGAGAGAATTGGACTTATA -> GAGAGAATTGGACTTATAT
GGAGAGAGCTGGGCGAAAT -> GAGAGAGCTGGGCGAAATG
GGAGAGCTCACTATATATC -> GAGAGCTCACTATATATCC
GGAGCATTATTAGTAGAAA -> GAGCATTATTAGTAGAAAT
GGAGCTGAGCCTGGGGATT -> GAGCTGAGCCTGGGGATTA
GGAGGCGCCCGGCTTTCAC -> GAGGCGCCCGGCTTTCACG
GGAGGGCGCTACGAGTAAG -> GAGGGCGCTACGAGTAAGC
GGAGGGCGGCTGTTCGGCA -> GAGGGCGGCTGTTCGGCAG
GGATATGGAGAGAATTGGA -> GATATGGAGAGAATTGGAC
GGATCATGTATAACTAGGG -> GATCATGTATAACTAGGGG
GGATCGGATCGGGATCTTT -> GATCGGATCGGGATCTTTT
GGATCGGGATCTTTTTCTC -> GATCGGGATCTTTTTCTCT
GGATCTTTTTCTCTTTCGC -> GATCTTTTTCTCTTTCGCA
GGATGAGGGACTACGAACT -> GATGAGGGACTACGAACTG
GGATGGTTAATTCTTCGCG -> GATGGTTAATTCTTCGCGG
GGATTAGCGAGTGGGTATC -> GATTAGCGAGTGGGTATCC
GGCAAGGCGTTGTGTAGGA -> GCAAGGCGTTGTGTAGGAC
GGCACCAGCGTACCGGTGC -> GCACCAGCGTACCGGTGCT
GGCACCGACTTTCGGGTCA -> GCACCGACTTTCGGGTCAT
GGCAGACGGTACGGCATAC -> GCAGACGGTACGGCATACC
GGCAGAGGAAGGGTCTCGG -> GCAGAGGAAGGGTCTCGGG
GGCAGCCCGCATTCACCTC -> GCAGCCCGCATTCACCTCA
GGCAGCCGTACTGCGAAGG -> GCAGCCGTACTGCGAAGGG
GGCATACCGTACGACCCCG -> GCATACCGTACGACCCCGA
GGCCATGACAGAGACTGTG -> GCCATGACAGAGACTGTGC
GGCCCTGTGACCACTTAGT -> GCCCTGTGACCACTTAGTT
GGCCGACTCTGAACCATGA -> GCCGACTCTGAACCATGAC
GGCCGCACGCTACATTTAC -> GCCGCACGCTACATTTACT
GGCCGGCACCAGCGTACCG -> GCCGGCACCAGCGTACCGG
GGCCGTAAGCAACACCTGC -> GCCGTAAGCAACACCTGCC
GGCCTGCTGCGGCGACTGT -> GCCTGCTGCGGCGACTGTG
GGCCTGGTCCGTTCCGGCA -> GCCTGGTCCGTTCCGGCAG
GGCGAAATGAGTCTCGAAC -> GCGAAATGAGTCTCGAACC
GGCGAACTCGTCCTTGGCA -> GCGAACTCGTCCTTGGCAG
GGCGACTGTGCAAGGACGA -> GCGACTGTGCAAGGACGAT
GGCGCCCGGCTTTCACGCC -> GCGCCCGGCTTTCACGCCT
GGCGCCCTGTCGTGGTGGG -> GCGCCCTGTCGTGGTGGGA
GGCGCTACGAGTAAGCCCG -> GCGCTACGAGTAAGCCCGT
GGCGCTGAAGTGGGGTCTA -> GCGCTGAAGTGGGGTCTAG
GGCGGCTGTTCGGCAGAGG -> GCGGCTGTTCGGCAGAGGA
GGCGGTCCTGACTTTCCAT -> GCGGTCCTGACTTTCCATT
GGCGTTGTGTAGGACAAGC -> GCGTTGTGTAGGACAAGCT
GGCTAAACGTAACTGAGCT -> GCTAAACGTAACTGAGCTT
GGCTATCCTTTGCATGGAG -> GCTATCCTTTGCATGGAGC
GGCTATTTAACCTCGTCCC -> GCTATTTAACCTCGTCCCC
GGCTCCAGATTCGAATGGT -> GCTCCAGATTCGAATGGTG
GGCTCCTGGCTGGACGTAC -> GCTCCTGGCTGGACGTACT
GGCTCTCCAGGCGGTCCTG -> GCTCTCCAGGCGGTCCTGA
GGCTGGACGTACTGTTGAC -> GCTGGACGTACTGTTGACA
GGCTGTCGGTCGTCCACTT -> GCTGTCGGTCGTCCACTTT
GGCTGTTCGGCAGAGGAAG -> GCTGTTCGGCAGAGGAAGG
GGCTTAATGCGACTTTTCC -> GCTTAATGCGACTTTTCCT
GGCTTGAACTTTTTCTCCA -> GCTTGAACTTTTTCTCCAG
GGCTTTCACGCCTCGGGGC -> GCTTTCACGCCTCGGGGCC
GGGAAGCAACACCTGCCTA -> GGAAGCAACACCTGCCTAG
GGGAATGCCGCATGTCGAG -> GGAATGCCGCATGTCGAGG
GGGACGGTTCGGTCAAAGA -> GGACGGTTCGGTCAAAGAT
GGGACGTGAAGACTAAGCG -> GGACGTGAAGACTAAGCGC
GGGACTACGAACTGACCTC -> GGACTACGAACTGACCTCA
GGGAGAGCTCACTATATAT -> GGAGAGCTCACTATATATC
GGGAGGGCGCTACGAGTAA -> GGAGGGCGCTACGAGTAAG
GGGATCATGTATAACTAGG -> GGATCATGTATAACTAGGG
GGGATCGGATCGGGATCTT -> GGATCGGATCGGGATCTTT
GGGATCTTTTTCTCTTTCG -> GGATCTTTTTCTCTTTCGC
GGGATTAGCGAGTGGGTAT -> GGATTAGCGAGTGGGTATC
GGGCACCGACTTTCGGGTC -> GGCACCGACTTTCGGGTCA
GGGCCATGACAGAGACTGT -> GGCCATGACAGAGACTGTG
GGGCCGGCACCAGCGTACC -> GGCCGGCACCAGCGTACCG
GGGCCTGGTCCGTTCCGGC -> GGCCTGGTCCGTTCCGGCA
GGGCGAAATGAGTCTCGAA -> GGCGAAATGAGTCTCGAAC
GGGCGCCCTGTCGTGGTGG -> GGCGCCCTGTCGTGGTGGG
GGGCGCTACGAGTAAGCCC -> GGCGCTACGAGTAAGCCCG
GGGCGGCTGTTCGGCAGAG -> GGCGGCTGTTCGGCAGAGG
GGGCTATTTAACCTCGTCC -> GGCTATTTAACCTCGTCCC
GGGCTCCAGATTCGAATGG -> GGCTCCAGATTCGAATGGT
GGGCTGTCGGTCGTCCACT -> GGCTGTCGGTCGTCCACTT
GGGGAAGCAACACCTGCCT -> GGGAAGCAACACCTGCCTA
GGGGAATGCCGCATGTCGA -> GGGAATGCCGCATGTCGAG
GGGGATTAGCGAGTGGGTA -> GGGATTAGCGAGTGGGTAT
GGGGCCGGCACCAGCGTAC -> GGGCCGGCACCAGCGTACC
GGGGTCTAGCAGAAGCGCG -> GGGTCTAGCAGAAGCGCGC
GGGGTTTGCAAGCAAATTT -> GGGTTTGCAAGCAAATTTA
GGGTAGCGCTTCGTCTTCT -> GGTAGCGCTTCGTCTTCTT
GGGTATCCAAATGTGATCC -> GGTATCCAAATGTGATCCG
GGGTCATGCTCCGCCCGTT -> GGTCATGCTCCGCCCGTTT
GGGTCGTAGAGCTGGCCGC -> GGTCGTAGAGCTGGCCGCA
GGGTCTAGCAGAAGCGCGC -> GGTCTAGCAGAAGCGCGCC
GGGTCTCGGGCACCGACTT -> GGTCTCGGGCACCGACTTT
GGGTTTGCAAGCAAATTTA -> GGTTTGCAAGCAAATTTAA
GGTAAATCAAAATACAGAG -> GTAAATCAAAATACAGAGT
GGTAATTTTTGTGGACTGT -> GTAATTTTTGTGGACTGTG
GGTACGGCATACCGTACGA -> GTACGGCATACCGTACGAC
GGTAGCGCTTCGTCTTCTT -> GTAGCGCTTCGTCTTCTTA
GGTATCCAAATGTGATCCG -> GTATCCAAATGTGATCCGT
GGTATTGGGATCATGTATA -> GTATTGGGATCATGTATAA
GGTCAAAGATTAGAACCCT -> GTCAAAGATTAGAACCCTT
GGTCACTCTAACATTGGCC -> GTCACTCTAACATTGGCCC
GGTCATGCTCCGCCCGTTT -> GTCATGCTCCGCCCGTTTT
GGTCCGTTCCGGCAGACGG -> GTCCGTTCCGGCAGACGGT
GGTCCTGACTTTCCATTTA -> GTCCTGACTTTCCATTTAG
GGTCGTAGAGCTGGCCGCA -> GTCGTAGAGCTGGCCGCAC
GGTCGTATCGATGGGGAAG -> GTCGTATCGATGGGGAAGC
GGTCGTCCACTTTACCTTC -> GTCGTCCACTTTACCTTCG
GGTCTAATCACACAATCCC -> GTCTAATCACACAATCCCG
GGTCTAGCAGAAGCGCGCC -> GTCTAGCAGAAGCGCGCCA
GGTCTCGGGCACCGACTTT -> GTCTCGGGCACCGACTTTC
GGTCTGCCCTTACTCGATT -> GTCTGCCCTTACTCGATTT
GGTGACGACTGCAGACGCG -> GTGACGACTGCAGACGCGT
GGTGCATTTGTTTAGTAAG -> GTGCATTTGTTTAGTAAGC
GGTGCTGCATGATGGGGAA -> GTGCTGCATGATGGGGAAT
GGTGGGAGAGCTCACTATA -> GTGGGAGAGCTCACTATAT
GGTGTACGCACTCCGTGAA -> GTGTACGCACTCCGTGAAG
GGTGTCGACCAACGCCATT -> GTGTCGACCAACGCCATTA
GGTTAATTCTTCGCGGCGA -> GTTAATTCTTCGCGGCGAA
GGTTATTAACAAGTCCGGA -> GTTATTAACAAGTCCGGAT
GGTTCGGTCAAAGATTAGA -> GTTCGGTCAAAGATTAGAA
GGTTTACGGACTGTGCAAG -> GTTTACGGACTGTGCAAGG
GGTTTGCAAGCAAATTTAA -> GTTTGCAAGCAAATTTAAT
GTAAAGCAACACCTGCCTA -> TAAAGCAACACCTGCCTAG
GTAAATCAAAATACAGAGT -> TAAATCAAAATACAGAGTA
GTAACTGAGCTTTTAGTCA -> TAACTGAGCTTTTAGTCAG
GTAAGACAGGCTTAATGCG -> TAAGACAGGCTTAATGCGA
GTAAGCAACACCTGCCTAG -> TAAGCAACACCTGCCTAGG
GTAAGCCCGTTATCTGCTC -> TAAGCCCGTTATCTGCTCG
GTAAGCCCTGTTACTACTC -> TAAGCCCTGTTACTACTCG
GTAATTTTTGTGGACTGTG -> TAATTTTTGTGGACTGTGC
GTACCGGTGCTGCATGATG -> TACCGGTGCTGCATGATGG
GTACCTTTTACTTGTTCGC -> TACCTTTTACTTGTTCGCC
GTACGACCCCGAAAATCTC -> TACGACCCCGAAAATCTCC
GTACGCACTCCGTGAAGCC -> TACGCACTCCGTGAAGCCA
GTACGCATCATACACTCCT -> TACGCATCATACACTCCTA
GTACGGCATACCGTACGAC -> TACGGCATACCGTACGACC
GTACTGCGAAGGGACGTGA -> TACTGCGAAGGGACGTGAA
GTACTGTGTCTAACGGGAT -> TACTGTGTCTAACGGGATC
GTACTGTTGACAATTTCTC -> TACTGTTGACAATTTCTCT
GTAGAAATTGACAGGAGGC -> TAGAAATTGACAGGAGGCG
GTAGAGCTGGCCGCACGCT -> TAGAGCTGGCCGCACGCTA
GTAGATTAGCTCACGTGCT -> TAGATTAGCTCACGTGCTG
GTAGCGCTTCGTCTTCTTA -> TAGCGCTTCGTCTTCTTAT
GTAGGACAAGCTCCACACA -> TAGGACAAGCTCCACACAC
GTATAACTAGGGGTTTGCA -> TATAACTAGGGGTTTGCAA
GTATAATCTTTTAGACAAC -> TATAATCTTTTAGACAACC
GTATCCAAATGTGATCCGT -> TATCCAAATGTGATCCGTT
GTATCGATGGGGAAGCAAC -> TATCGATGGGGAAGCAACA
GTATCGTGTCCCCGCACGG -> TATCGTGTCCCCGCACGGA
GTATGCCCGGGCTATTTAA -> TATGCCCGGGCTATTTAAC
GTATTGGGATCATGTATAA -> TATTGGGATCATGTATAAC
GTCAAAGATTAGAACCCTT -> TCAAAGATTAGAACCCTTC
GTCACTCTAACATTGGCCC -> TCACTCTAACATTGGCCCT
GTCAGAAATGACTAGGAGA -> TCAGAAATGACTAGGAGAG
GTCAGGGAGGGCGCTACGA -> TCAGGGAGGGCGCTACGAG
GTCATGCTCCGCCCGTTTT -> TCATGCTCCGCCCGTTTTC
GTCCACTTTACCTTCGGAA -> TCCACTTTACCTTCGGAAC
GTCCCCAAGCACTCCCGGC -> TCCCCAAGCACTCCCGGCT
GTCCCCGCACGGATGGTTA -> TCCCCGCACGGATGGTTAA
GTCCGGATATGGAGAGAAT -> TCCGGATATGGAGAGAATT
GTCCGTTCCGGCAGACGGT -> TCCGTTCCGGCAGACGGTA
GTCCTGACTTTCCATTTAG -> TCCTGACTTTCCATTTAGA
GTCCTTGGCAGCCCGCATT -> TCCTTGGCAGCCCGCATTC
GTCGACCAACGCCATTACG -> TCGACCAACGCCATTACGA
GTCGAGGGCTGTCGGTCGT -> TCGAGGGCTGTCGGTCGTC
GTCGATTTCCTGCTAAAAC -> TCGATTTCCTGCTAAAACA
GTCGGTCGTCCACTTTACC -> TCGGTCGTCCACTTTACCT
GTCGTAGAGCTGGCCGCAC -> TCGTAGAGCTGGCCGCACG
GTCGTATCGATGGGGAAGC -> TCGTATCGATGGGGAAGCA
GTCGTCCACTTTACCTTCG -> TCGTCCACTTTACCTTCGG
GTCGTGGTGGGAGAGCTCA -> TCGTGGTGGGAGAGCTCAC
GTCTAACGGGATCGGATCG -> TCTAACGGGATCGGATCGG
GTCTAATCACACAATCCCG -> TCTAATCACACAATCCCGA
GTCTAGCAGAAGCGCGCCA -> TCTAGCAGAAGCGCGCCAC
GTCTCGAACCCACGCGGCC -> TCTCGAACCCACGCGGCCG
GTCTCGGGCACCGACTTTC -> TCTCGGGCACCGACTTTCG
GTCTCTCGTAAAGCAACAC -> TCTCTCGTAAAGCAACACC
GTCTGATGCCGGAAAACGA -> TCTGATGCCGGAAAACGAA
GTCTGCCCTTACTCGATTT -> TCTGCCCTTACTCGATTTT
GTCTTCTTATTTCCTGGTC -> TCTTCTTATTTCCTGGTCT
GTGAAGACTAAGCGCTCCA -> TGAAGACTAAGCGCTCCAA
GTGAAGCCATTATTCCCCG -> TGAAGCCATTATTCCCCGA
GTGACCACTTAGTTACACA -> TGACCACTTAGTTACACAT
GTGACGACTGCAGACGCGT -> TGACGACTGCAGACGCGTC
GTGACGCTATCCACATCCG -> TGACGCTATCCACATCCGA
GTGATCCGTTAGAACGGAG -> TGATCCGTTAGAACGGAGC
GTGATGCCTCGTCAGAAAT -> TGATGCCTCGTCAGAAATG
GTGATTGGTGTCGACCAAC -> TGATTGGTGTCGACCAACG
GTGCAAGGACGATCCAGAC -> TGCAAGGACGATCCAGACT
GTGCAAGGACGATCCCGTG -> TGCAAGGACGATCCCGTGG
GTGCAAGGACGATCCCGTT -> TGCAAGGACGATCCCGTTA
GTGCAAGGACGATCCGCTA -> TGCAAGGACGATCCGCTAA
GTGCATTTGTTTAGTAAGC -> TGCATTTGTTTAGTAAGCC
GTGCCGAGATGCTATAGCA -> TGCCGAGATGCTATAGCAG
GTGCCTTCCGGCAGCCGTA -> TGCCTTCCGGCAGCCGTAC
GTGCTGCATGAACTCGTGC -> TGCTGCATGAACTCGTGCC
GTGCTGCATGATGGGGAAT -> TGCTGCATGATGGGGAATG
GTGGACTGTGCAAGGACGA -> TGGACTGTGCAAGGACGAT
GTGGAGGGCGGCTGTTCGG -> TGGAGGGCGGCTGTTCGGC
GTGGGAGAGCTCACTATAT -> TGGGAGAGCTCACTATATA
GTGGGGTCTAGCAGAAGCG -> TGGGGTCTAGCAGAAGCGC
GTGGGTATCCAAATGTGAT -> TGGGTATCCAAATGTGATC
GTGGTGGGAGAGCTCACTA -> TGGTGGGAGAGCTCACTAT
GTGTACGCACTCCGTGAAG -> TGTACGCACTCCGTGAAGC
GTGTAGGACAAGCTCCACA -> TGTAGGACAAGCTCCACAC
GTGTCCCCGCACGGATGGT -> TGTCCCCGCACGGATGGTT
GTGTCGACCAACGCCATTA -> TGTCGACCAACGCCATTAC
GTGTCTAACGGGATCGGAT -> TGTCTAACGGGATCGGATC
GTGTTAACACGCCTATTGT -> TGTTAACACGCCTATTGTC
GTTAACACGCCTATTGTCT -> TTAACACGCCTATTGTCTG
GTTAATCCACGGTTATTAA -> TTAATCCACGGTTATTAAC
GTTAATTCTTCGCGGCGAA -> TTAATTCTTCGCGGCGAAC
GTTACACATCGACTCCCGG -> TTACACATCGACTCCCGGC
GTTACTACTCGGCGCTGAA -> TTACTACTCGGCGCTGAAG
GTTAGAACGGAGCATTATT -> TTAGAACGGAGCATTATTA
GTTAGAACGTTCCTAACTA -> TTAGAACGTTCCTAACTAA
GTTATCTGCTCGCAATCGT -> TTATCTGCTCGCAATCGTA
GTTATTAACAAGTCCGGAT -> TTATTAACAAGTCCGGATA
GTTCCGGCAGACGGTACGG -> TTCCGGCAGACGGTACGGC
GTTCCTAACTAATTGCAAG -> TTCCTAACTAATTGCAAGC
GTTCGCCGTGTTAACACGC -> TTCGCCGTGTTAACACGCC
GTTCGGCAGAGGAAGGGTC -> TTCGGCAGAGGAAGGGTCT
GTTCGGTCAAAGATTAGAA -> TTCGGTCAAAGATTAGAAC
GTTGACAATTTCTCTTATG -> TTGACAATTTCTCTTATGG
GTTGACGTACGCATCATAC -> TTGACGTACGCATCATACA
GTTGTGTAGGACAAGCTCC -> TTGTGTAGGACAAGCTCCA
GTTTACGGACTGTGCAAGG -> TTTACGGACTGTGCAAGGA
GTTTAGTAAGCCCTGTTAC -> TTTAGTAAGCCCTGTTACT
GTTTATAAACAGGGTAGCG -> TTTATAAACAGGGTAGCGC
GTTTGCAAGCAAATTTAAT -> TTTGCAAGCAAATTTAATG
GTTTGCATTCTCCAACAAA -> TTTGCATTCTCCAACAAAC
GTTTTCCGGGCTCCAGATT -> TTTTCCGGGCTCCAGATTC
TAAAACAGACAAGTGACGC -> AAAACAGACAAGTGACGCT
TAAAATAAAGGGCCTGGTC -> AAAATAAAGGGCCTGGTCC
TAAACAGGGTAGCGCTTCG -> AAACAGGGTAGCGCTTCGT
TAAACGGGCGCCCTGTCGT -> AAACGGGCGCCCTGTCGTG
TAAACGTAACTGAGCTTTT -> AAACGTAACTGAGCTTTTA
TAAAGCAACACCTGCCTAG -> AAAGCAACACCTGCCTAGG
TAAAGCTTCCTCTGAAAAG -> AAAGCTTCCTCTGAAAAGT
TAAAGGGCCTGGTCCGTTC -> AAAGGGCCTGGTCCGTTCC
TAAATCAAAATACAGAGTA -> AAATCAAAATACAGAGTAA
TAACAAGTCCGGATATGGA -> AACAAGTCCGGATATGGAG
TAACACGCCTATTGTCTGA -> AACACGCCTATTGTCTGAT
TAACATTGGCCCTGTGACC -> AACATTGGCCCTGTGACCA
TAACCACGCGCGTATCGTG -> AACCACGCGCGTATCGTGT
TAACCTCGTCCCCAAGCAC -> AACCTCGTCCCCAAGCACT
TAACGGGATCGGATCGGGA -> AACGGGATCGGATCGGGAT
TAACTAATTGCAAGCAACA -> AACTAATTGCAAGCAACAC
TAACTAGGGGTTTGCAAGC -> AACTAGGGGTTTGCAAGCA
TAACTGAGCTTTTAGTCAG -> AACTGAGCTTTTAGTCAGG
TAAGACAGGCTTAATGCGA -> AAGACAGGCTTAATGCGAC
TAAGACTTGAAGCCAACCA -> AAGACTTGAAGCCAACCAC
TAAGCAACACCTGCCTAGG -> AAGCAACACCTGCCTAGGT
TAAGCCCGTTATCTGCTCG -> AAGCCCGTTATCTGCTCGC
TAAGCCCTGTTACTACTCG -> AAGCCCTGTTACTACTCGG
TAAGCGCTCCAAACTCCTC -> AAGCGCTCCAAACTCCTCT
TAATCACACAATCCCGACA -> AATCACACAATCCCGACAG
TAATCCACGGTTATTAACA -> AATCCACGGTTATTAACAA
TAATCTTTTAGACAACCCT -> AATCTTTTAGACAACCCTT
TAATGCCAACTGGTGCATT -> AATGCCAACTGGTGCATTT
TAATGCCAAGTAGATTAGC -> AATGCCAAGTAGATTAGCT
TAATGCGACTTTTCCTATC -> AATGCGACTTTTCCTATCG
TAATGGAATGCCTCACAGT -> AATGGAATGCCTCACAGTT
TAATTCTTCGCGGCGAACT -> AATTCTTCGCGGCGAACTC
TAATTGCAAGCAACACCTG -> AATTGCAAGCAACACCTGC
TAATTTTTGTGGACTGTGC -> AATTTTTGTGGACTGTGCA
TACACATCGACTCCCGGCT -> ACACATCGACTCCCGGCTC
TACACTCCTATGACTGCAC -> ACACTCCTATGACTGCACA
TACAGAGTAAGACAGGCTT -> ACAGAGTAAGACAGGCTTA
TACAGATACCTCCCCTTTC -> ACAGATACCTCCCCTTTCA
TACATTTACTCTTCCGGCC -> ACATTTACTCTTCCGGCCG
TACCGGTGCTGCATGATGG -> ACCGGTGCTGCATGATGGG
TACCGTACGACCCCGAAAA -> ACCGTACGACCCCGAAAAT
TACCTCCCCTTTCACATGC -> ACCTCCCCTTTCACATGCG
TACCTTCGGAACAAGTTGA -> ACCTTCGGAACAAGTTGAC
TACCTTTTACTTGTTCGCC -> ACCTTTTACTTGTTCGCCG
TACGAACTGACCTCACCCT -> ACGAACTGACCTCACCCTA
TACGACCCCGAAAATCTCC -> ACGACCCCGAAAATCTCCG
TACGACGGTAAATCAAAAT -> ACGACGGTAAATCAAAATA
TACGAGTAAGCCCGTTATC -> ACGAGTAAGCCCGTTATCT
TACGCACTCCGTGAAGCCA -> ACGCACTCCGTGAAGCCAT
TACGCATCATACACTCCTA -> ACGCATCATACACTCCTAT
TACGGACTGTGCAAGGACG -> ACGGACTGTGCAAGGACGA
TACGGCATACCGTACGACC -> ACGGCATACCGTACGACCC
TACTACTCGGCGCTGAAGT -> ACTACTCGGCGCTGAAGTG
TACTATATAAAGCTTCCTC -> ACTATATAAAGCTTCCTCT
TACTCGATTTTCTAATGCC -> ACTCGATTTTCTAATGCCA
TACTCGGCGCTGAAGTGGG -> ACTCGGCGCTGAAGTGGGG
TACTCTTCCGGCCGTAAGC -> ACTCTTCCGGCCGTAAGCA
TACTGCGAAGGGACGTGAA -> ACTGCGAAGGGACGTGAAG
TACTGTGTCTAACGGGATC -> ACTGTGTCTAACGGGATCG
TACTGTTGACAATTTCTCT -> ACTGTTGACAATTTCTCTT
TACTTGTTCGCCGTGTTAA -> ACTTGTTCGCCGTGTTAAC
TAGAAATTGACAGGAGGCG -> AGAAATTGACAGGAGGCGC
TAGAACCCTTCTGCGGCTA -> AGAACCCTTCTGCGGCTAA
TAGAACGGAGCATTATTAG -> AGAACGGAGCATTATTAGT
TAGAACGTTCCTAACTAAT -> AGAACGTTCCTAACTAATT
TAGACAACCCTTCAGAAAC -> AGACAACCCTTCAGAAACG
TAGACTGGCTATCCTTTGC -> AGACTGGCTATCCTTTGCA
TAGAGCTGGCCGCACGCTA -> AGAGCTGGCCGCACGCTAC
TAGATATGAGTTTGCATTC -> AGATATGAGTTTGCATTCT
TAGATTAGCTCACGTGCTG -> AGATTAGCTCACGTGCTGC
TAGCAGAAGCGCGCCACCC -> AGCAGAAGCGCGCCACCCT
TAGCAGCCCCGAGATTGTA -> AGCAGCCCCGAGATTGTAT
TAGCCCTTGCTTCGAATGA -> AGCCCTTGCTTCGAATGAG
TAGCGAGTGGGTATCCAAA -> AGCGAGTGGGTATCCAAAT
TAGCGCTTCGTCTTCTTAT -> AGCGCTTCGTCTTCTTATT
TAGCTCACGTGCTGCATGA -> AGCTCACGTGCTGCATGAA
TAGGACAAGCTCCACACAC -> AGGACAAGCTCCACACACT
TAGGACCGGTTTACGGACT -> AGGACCGGTTTACGGACTG
TAGGAGAGAGCTGGGCGAA -> AGGAGAGAGCTGGGCGAAA
TAGGCCTGCTGCGGCGACT -> AGGCCTGCTGCGGCGACTG
TAGGGCCATGACAGAGACT -> AGGGCCATGACAGAGACTG
TAGGGGTTTGCAAGCAAAT -> AGGGGTTTGCAAGCAAATT
TAGGTAATTTTTGTGGACT -> AGGTAATTTTTGTGGACTG
TAGTAAGCCCTGTTACTAC -> AGTAAGCCCTGTTACTACT
TAGTAGAAATTGACAGGAG -> AGTAGAAATTGACAGGAGG
TAGTCAGGGAGGGCGCTAC -> AGTCAGGGAGGGCGCTACG
TAGTGATGCCTCGTCAGAA -> AGTGATGCCTCGTCAGAAA
TAGTTACACATCGACTCCC -> AGTTACACATCGACTCCCG
TATAAACAGGGTAGCGCTT -> ATAAACAGGGTAGCGCTTC
TATAAAGCTTCCTCTGAAA -> ATAAAGCTTCCTCTGAAAA
TATAACTAGGGGTTTGCAA -> ATAACTAGGGGTTTGCAAG
TATAATCTTTTAGACAACC -> ATAATCTTTTAGACAACCC
TATAGCAGCCCCGAGATTG -> ATAGCAGCCCCGAGATTGT
TATATAAAGCTTCCTCTGA -> ATATAAAGCTTCCTCTGAA
TATATATCCGAGGCAAGGC -> ATATATCCGAGGCAAGGCG
TATATCCGAGGCAAGGCGT -> ATATCCGAGGCAAGGCGTT
TATATTCTTAACCACGCGC -> ATATTCTTAACCACGCGCG
TATCCAAATGTGATCCGTT -> ATCCAAATGTGATCCGTTA
TATCCACATCCGATTAAGA -> ATCCACATCCGATTAAGAC
TATCCGAGGCAAGGCGTTG -> ATCCGAGGCAAGGCGTTGT
TATCCTTTGCATGGAGCTG -> ATCCTTTGCATGGAGCTGA
TATCGACGGATGAGGGACT -> ATCGACGGATGAGGGACTA
TATCGATGGGGAAGCAACA -> ATCGATGGGGAAGCAACAC
TATCGTGTCCCCGCACGGA -> ATCGTGTCCCCGCACGGAT
TATCTGCTCGCAATCGTAC -> ATCTGCTCGCAATCGTACT
TATGACTGCACAACGTATG -> ATGACTGCACAACGTATGC
TATGAGTTTGCATTCTCCA -> ATGAGTTTGCATTCTCCAA
TATGCCCGGGCTATTTAAC -> ATGCCCGGGCTATTTAACC
TATGGAGAGAATTGGACTT -> ATGGAGAGAATTGGACTTA
TATGGGACGGTTCGGTCAA -> ATGGGACGGTTCGGTCAAA
TATTAACAAGTCCGGATAT -> ATTAACAAGTCCGGATATG
TATTAGTAGAAATTGACAG -> ATTAGTAGAAATTGACAGG
TATTATTCATAGACTGGCT -> ATTATTCATAGACTGGCTA
TATTCATAGACTGGCTATC -> ATTCATAGACTGGCTATCC
TATTCCCCGATCGTTTATA -> ATTCCCCGATCGTTTATAA
TATTCTTAACCACGCGCGT -> ATTCTTAACCACGCGCGTA
TATTGGGATCATGTATAAC -> ATTGGGATCATGTATAACT
TATTGTCTGATGCCGGAAA -> ATTGTCTGATGCCGGAAAA
TATTTAACCTCGTCCCCAA -> ATTTAACCTCGTCCCCAAG
TATTTCCTGGTCTGCCCTT -> ATTTCCTGGTCTGCCCTTA
TCAAAATACAGAGTAAGAC -> CAAAATACAGAGTAAGACA
TCAAAGATTAGAACCCTTC -> CAAAGATTAGAACCCTTCT
TCAATCGCAGCGCACTAAT -> CAATCGCAGCGCACTAATG
TCACACAATCCCGACAGGT -> CACACAATCCCGACAGGTA
TCACAGTTAGAACGTTCCT -> CACAGTTAGAACGTTCCTA
TCACATGCGAAAGAAGATT -> CACATGCGAAAGAAGATTT
TCACCCTAGCCCTTGCTTC -> CACCCTAGCCCTTGCTTCG
TCACCTCAATCGCAGCGCA -> CACCTCAATCGCAGCGCAC
TCACGCCTCGGGGCCGGCA -> CACGCCTCGGGGCCGGCAC
TCACGTGCTGCATGAACTC -> CACGTGCTGCATGAACTCG
TCACTATATATCCGAGGCA -> CACTATATATCCGAGGCAA
TCACTCTAACATTGGCCCT -> CACTCTAACATTGGCCCTG
TCAGAAACGGAAGTGATTG -> CAGAAACGGAAGTGATTGG
TCAGAAATGACTAGGAGAG -> CAGAAATGACTAGGAGAGA
TCAGGGAGGGCGCTACGAG -> CAGGGAGGGCGCTACGAGT
TCATACACTCCTATGACTG -> CATACACTCCTATGACTGC
TCATAGACTGGCTATCCTT -> CATAGACTGGCTATCCTTT
TCATGCTCCGCCCGTTTTC -> CATGCTCCGCCCGTTTTCC
TCATGTATAACTAGGGGTT -> CATGTATAACTAGGGGTTT
TCCAAACTCCTCTTTTGGG -> CCAAACTCCTCTTTTGGGT
TCCAAATGTGATCCGTTAG -> CCAAATGTGATCCGTTAGA
TCCAACAAACCGCATGCGG -> CCAACAAACCGCATGCGGT
TCCACACACTTTGTACCTT -> CCACACACTTTGTACCTTT
TCCACATCCGATTAAGACT -> CCACATCCGATTAAGACTT
TCCACGGTTATTAACAAGT -> CCACGGTTATTAACAAGTC
TCCACTTTACCTTCGGAAC -> CCACTTTACCTTCGGAACA
TCCAGACTGTCGATTTCCT -> CCAGACTGTCGATTTCCTG
TCCAGATTCGAATGGTGAC -> CCAGATTCGAATGGTGACG
TCCAGCCCTGCCCCCCTTT -> CCAGCCCTGCCCCCCTTTT
TCCAGGCGGTCCTGACTTT -> CCAGGCGGTCCTGACTTTC
TCCATTTAGATATGAGTTT -> CCATTTAGATATGAGTTTG
TCCCCAAGCACTCCCGGCT -> CCCCAAGCACTCCCGGCTT
TCCCCGATCGTTTATAAAC -> CCCCGATCGTTTATAAACA
TCCCCGCACGGATGGTTAA -> CCCCGCACGGATGGTTAAT
TCCCCTTTCACATGCGAAA -> CCCCTTTCACATGCGAAAG
TCCCGACAGGTATTGGGAT -> CCCGACAGGTATTGGGATC
TCCCGGCTCTCCAGGCGGT -> CCCGGCTCTCCAGGCGGTC
TCCCGGCTTGAACTTTTTC -> CCCGGCTTGAACTTTTTCT
TCCCGTGGAGGGCGGCTGT -> CCCGTGGAGGGCGGCTGTT
TCCCGTTAATCCACGGTTA -> CCCGTTAATCCACGGTTAT
TCCCTTGACTACTATATAA -> CCCTTGACTACTATATAAA
TCCGAGGCAAGGCGTTGTG -> CCGAGGCAAGGCGTTGTGT
TCCGAGGCATCGGAGGCAA -> CCGAGGCATCGGAGGCAAC
TCCGATTAAGACTTGAAGC -> CCGATTAAGACTTGAAGCC
TCCGCCCGTTTTCCGGGCT -> CCGCCCGTTTTCCGGGCTC
TCCGCTAAACGGGCGCCCT -> CCGCTAAACGGGCGCCCTG
TCCGGATATGGAGAGAATT -> CCGGATATGGAGAGAATTG
TCCGGCAGACGGTACGGCA -> CCGGCAGACGGTACGGCAT
TCCGGCAGCCGTACTGCGA -> CCGGCAGCCGTACTGCGAA
TCCGGCCGTAAGCAACACC -> CCGGCCGTAAGCAACACCT
TCCGGGCTCCAGATTCGAA -> CCGGGCTCCAGATTCGAAT
TCCGTGAAGCCATTATTCC -> CCGTGAAGCCATTATTCCC
TCCGTTAGAACGGAGCATT -> CCGTTAGAACGGAGCATTA
TCCGTTCCGGCAGACGGTA -> CCGTTCCGGCAGACGGTAC
TCCTAACTAATTGCAAGCA -> CCTAACTAATTGCAAGCAA
TCCTATCGACGGATGAGGG -> CCTATCGACGGATGAGGGA
TCCTATGACTGCACAACGT -> CCTATGACTGCACAACGTA
TCCTCTGAAAAGTGCCGAG -> CCTCTGAAAAGTGCCGAGA
TCCTCTTATTATTCATAGA -> CCTCTTATTATTCATAGAC
TCCTCTTTTGGGTCGTAGA -> CCTCTTTTGGGTCGTAGAG
TCCTGACTTTCCATTTAGA -> CCTGACTTTCCATTTAGAT
TCCTGCTAAAACAGACAAG -> CCTGCTAAAACAGACAAGT
TCCTGGCTGGACGTACTGT -> CCTGGCTGGACGTACTGTT
TCCTGGTCTGCCCTTACTC -> CCTGGTCTGCCCTTACTCG
TCCTTGGCAGCCCGCATTC -> CCTTGGCAGCCCGCATTCA
TCCTTTGCATGGAGCTGAG -> CCTTTGCATGGAGCTGAGC
TCGAACCCACGCGGCCGAC -> CGAACCCACGCGGCCGACT
TCGAATGAGACAGAGAGGT -> CGAATGAGACAGAGAGGTG
TCGAATGGTGACGACTGCA -> CGAATGGTGACGACTGCAG
TCGACCAACGCCATTACGA -> CGACCAACGCCATTACGAC
TCGACGGATGAGGGACTAC -> CGACGGATGAGGGACTACG
TCGACTCCCGGCTCTCCAG -> CGACTCCCGGCTCTCCAGG
TCGAGGGCTGTCGGTCGTC -> CGAGGGCTGTCGGTCGTCC
TCGATGGGGAAGCAACACC -> CGATGGGGAAGCAACACCT
TCGATTTCCTGCTAAAACA -> CGATTTCCTGCTAAAACAG
TCGATTTTCTAATGCCAAG -> CGATTTTCTAATGCCAAGT
TCGCAATCGTACTGTGTCT -> CGCAATCGTACTGTGTCTA
TCGCAGCGCACTAATGCCA -> CGCAGCGCACTAATGCCAA
TCGCATACAGATACCTCCC -> CGCATACAGATACCTCCCC
TCGCCGTGTTAACACGCCT -> CGCCGTGTTAACACGCCTA
TCGCGGCGAACTCGTCCTT -> CGCGGCGAACTCGTCCTTG
TCGGAACAAGTTGACGTAC -> CGGAACAAGTTGACGTACG
TCGGATCGGGATCTTTTTC -> CGGATCGGGATCTTTTTCT
TCGGCAGAGGAAGGGTCTC -> CGGCAGAGGAAGGGTCTCG
TCGGCGCTGAAGTGGGGTC -> CGGCGCTGAAGTGGGGTCT
TCGGCTCCTGGCTGGACGT -> CGGCTCCTGGCTGGACGTA
TCGGGATCTTTTTCTCTTT -> CGGGATCTTTTTCTCTTTC
TCGGGCACCGACTTTCGGG -> CGGGCACCGACTTTCGGGT
TCGGGGCCGGCACCAGCGT -> CGGGGCCGGCACCAGCGTA
TCGGGTCATGCTCCGCCCG -> CGGGTCATGCTCCGCCCGT
TCGGTCAAAGATTAGAACC -> CGGTCAAAGATTAGAACCC
TCGGTCGTCCACTTTACCT -> CGGTCGTCCACTTTACCTT
TCGTAAAGCAACACCTGCC -> CGTAAAGCAACACCTGCCT
TCGTACTGTGTCTAACGGG -> CGTACTGTGTCTAACGGGA
TCGTAGAGCTGGCCGCACG -> CGTAGAGCTGGCCGCACGC
TCGTATCGATGGGGAAGCA -> CGTATCGATGGGGAAGCAA
TCGTCAGAAATGACTAGGA -> CGTCAGAAATGACTAGGAG
TCGTCCACTTTACCTTCGG -> CGTCCACTTTACCTTCGGA
TCGTCCCCAAGCACTCCCG -> CGTCCCCAAGCACTCCCGG
TCGTCCTTGGCAGCCCGCA -> CGTCCTTGGCAGCCCGCAT
TCGTCTTCTTATTTCCTGG -> CGTCTTCTTATTTCCTGGT
TCGTGCCTTCCGGCAGCCG -> CGTGCCTTCCGGCAGCCGT
TCGTGGTGGGAGAGCTCAC -> CGTGGTGGGAGAGCTCACT
TCGTGTCCCCGCACGGATG -> CGTGTCCCCGCACGGATGG
TCGTTTATAAACAGGGTAG -> CGTTTATAAACAGGGTAGC
TCTAACATTGGCCCTGTGA -> CTAACATTGGCCCTGTGAC
TCTAACGGGATCGGATCGG -> CTAACGGGATCGGATCGGG
TCTAATCACACAATCCCGA -> CTAATCACACAATCCCGAC
TCTAATGCCAAGTAGATTA -> CTAATGCCAAGTAGATTAG
TCTAGCAGAAGCGCGCCAC -> CTAGCAGAAGCGCGCCACC
TCTCCAACAAACCGCATGC -> CTCCAACAAACCGCATGCG
TCTCCAGCCCTGCCCCCCT -> CTCCAGCCCTGCCCCCCTT
TCTCCAGGCGGTCCTGACT -> CTCCAGGCGGTCCTGACTT
TCTCCGAGGCATCGGAGGC -> CTCCGAGGCATCGGAGGCA
TCTCGAACCCACGCGGCCG -> CTCGAACCCACGCGGCCGA
TCTCGGGCACCGACTTTCG -> CTCGGGCACCGACTTTCGG
TCTCGTAAAGCAACACCTG -> CTCGTAAAGCAACACCTGC
TCTCTCGTAAAGCAACACC -> CTCTCGTAAAGCAACACCT
TCTCTTATGGGACGGTTCG -> CTCTTATGGGACGGTTCGG
TCTCTTTCGCATACAGATA -> CTCTTTCGCATACAGATAC
TCTGAAAAGTGCCGAGATG -> CTGAAAAGTGCCGAGATGC
TCTGAACCATGACATTCGG -> CTGAACCATGACATTCGGC
TCTGATGCCGGAAAACGAA -> CTGATGCCGGAAAACGAAA
TCTGCCCTTACTCGATTTT -> CTGCCCTTACTCGATTTTC
TCTGCGGCTAAACGTAACT -> CTGCGGCTAAACGTAACTG
TCTGCTCGCAATCGTACTG -> CTGCTCGCAATCGTACTGT
TCTTAACCACGCGCGTATC -> CTTAACCACGCGCGTATCG
TCTTATGGGACGGTTCGGT -> CTTATGGGACGGTTCGGTC
TCTTATTATTCATAGACTG -> CTTATTATTCATAGACTGG
TCTTATTTCCTGGTCTGCC -> CTTATTTCCTGGTCTGCCC
TCTTCCGGCCGTAAGCAAC -> CTTCCGGCCGTAAGCAACA
TCTTCGCGGCGAACTCGTC -> CTTCGCGGCGAACTCGTCC
TCTTCTTATTTCCTGGTCT -> CTTCTTATTTCCTGGTCTG
TCTTTCGCATACAGATACC -> CTTTCGCATACAGATACCT
TCTTTTAGACAACCCTTCA -> CTTTTAGACAACCCTTCAG
TCTTTTGGGTCGTAGAGCT -> CTTTTGGGTCGTAGAGCTG
TCTTTTTCTCTTTCGCATA -> CTTTTTCTCTTTCGCATAC
TGAAAAGTGCCGAGATGCT -> GAAAAGTGCCGAGATGCTA
TGAACCATGACATTCGGCT -> GAACCATGACATTCGGCTC
TGAACTCGTGCCTTCCGGC -> GAACTCGTGCCTTCCGGCA
TGAACTTTTTCTCCAGCCC -> GAACTTTTTCTCCAGCCCT
TGAAGACTAAGCGCTCCAA -> GAAGACTAAGCGCTCCAAA
TGAAGCCAACCACAGCTCC -> GAAGCCAACCACAGCTCCC
TGAAGCCATTATTCCCCGA -> GAAGCCATTATTCCCCGAT
TGAAGTGGGGTCTAGCAGA -> GAAGTGGGGTCTAGCAGAA
TGACAATTTCTCTTATGGG -> GACAATTTCTCTTATGGGA
TGACAGAGACTGTGCAAGG -> GACAGAGACTGTGCAAGGA
TGACAGGAGGCGCCCGGCT -> GACAGGAGGCGCCCGGCTT
TGACATTCGGCTCCTGGCT -> GACATTCGGCTCCTGGCTG
TGACCACTTAGTTACACAT -> GACCACTTAGTTACACATC
TGACCTCACCCTAGCCCTT -> GACCTCACCCTAGCCCTTG
TGACGACTGCAGACGCGTC -> GACGACTGCAGACGCGTCT
TGACGCTATCCACATCCGA -> GACGCTATCCACATCCGAT
TGACGTACGCATCATACAC -> GACGTACGCATCATACACT
TGACTACTATATAAAGCTT -> GACTACTATATAAAGCTTC
TGACTAGGAGAGAGCTGGG -> GACTAGGAGAGAGCTGGGC
TGACTGCACAACGTATGCC -> GACTGCACAACGTATGCCC
TGACTTTCCATTTAGATAT -> GACTTTCCATTTAGATATG
TGAGACAGAGAGGTGTACG -> GAGACAGAGAGGTGTACGC
TGAGCCTGGGGATTAGCGA -> GAGCCTGGGGATTAGCGAG
TGAGCTTTTAGTCAGGGAG -> GAGCTTTTAGTCAGGGAGG
TGAGGGACTACGAACTGAC -> GAGGGACTACGAACTGACC
TGAGTCTCGAACCCACGCG -> GAGTCTCGAACCCACGCGG
TGAGTTTGCATTCTCCAAC -> GAGTTTGCATTCTCCAACA
TGATCCGTTAGAACGGAGC -> GATCCGTTAGAACGGAGCA
TGATGCCGGAAAACGAAAA -> GATGCCGGAAAACGAAAAT
TGATGCCTCGTCAGAAATG -> GATGCCTCGTCAGAAATGA
TGATGGGGAATGCCGCATG -> GATGGGGAATGCCGCATGT
TGATTGGTGTCGACCAACG -> GATTGGTGTCGACCAACGC
TGCAAGCAAATTTAATGGA -> GCAAGCAAATTTAATGGAA
TGCAAGCAACACCTGCCTA -> GCAAGCAACACCTGCCTAG
TGCAAGGACGATCCAGACT -> GCAAGGACGATCCAGACTG
TGCAAGGACGATCCCGTGG -> GCAAGGACGATCCCGTGGA
TGCAAGGACGATCCCGTTA -> GCAAGGACGATCCCGTTAA
TGCAAGGACGATCCGCTAA -> GCAAGGACGATCCGCTAAA
TGCACAACGTATGCCCGGG -> GCACAACGTATGCCCGGGC
TGCAGACGCGTCTCTCGTA -> GCAGACGCGTCTCTCGTAA
TGCATGAACTCGTGCCTTC -> GCATGAACTCGTGCCTTCC
TGCATGATGGGGAATGCCG -> GCATGATGGGGAATGCCGC
TGCATGGAGCTGAGCCTGG -> GCATGGAGCTGAGCCTGGG
TGCATTCTCCAACAAACCG -> GCATTCTCCAACAAACCGC
TGCATTTGTTTAGTAAGCC -> GCATTTGTTTAGTAAGCCC
TGCCAACTGGTGCATTTGT -> GCCAACTGGTGCATTTGTT
TGCCAAGTAGATTAGCTCA -> GCCAAGTAGATTAGCTCAC
TGCCCCCCTTTTAGTGATG -> GCCCCCCTTTTAGTGATGC
TGCCCGGGCTATTTAACCT -> GCCCGGGCTATTTAACCTC
TGCCCTTACTCGATTTTCT -> GCCCTTACTCGATTTTCTA
TGCCGAGATGCTATAGCAG -> GCCGAGATGCTATAGCAGC
TGCCGCATGTCGAGGGCTG -> GCCGCATGTCGAGGGCTGT
TGCCGGAAAACGAAAATGG -> GCCGGAAAACGAAAATGGT
TGCCGGTCTAATCACACAA -> GCCGGTCTAATCACACAAT
TGCCTAGGACCGGTTTACG -> GCCTAGGACCGGTTTACGG
TGCCTAGGCCTGCTGCGGC -> GCCTAGGCCTGCTGCGGCG
TGCCTAGGGCCATGACAGA -> GCCTAGGGCCATGACAGAG
TGCCTAGGTAATTTTTGTG -> GCCTAGGTAATTTTTGTGG
TGCCTCACAGTTAGAACGT -> GCCTCACAGTTAGAACGTT
TGCCTCGTCAGAAATGACT -> GCCTCGTCAGAAATGACTA
TGCCTTCCGGCAGCCGTAC -> GCCTTCCGGCAGCCGTACT
TGCGAAAGAAGATTTGCCG -> GCGAAAGAAGATTTGCCGG
TGCGAAGGGACGTGAAGAC -> GCGAAGGGACGTGAAGACT
TGCGACTTTTCCTATCGAC -> GCGACTTTTCCTATCGACG
TGCGGCGACTGTGCAAGGA -> GCGGCGACTGTGCAAGGAC
TGCGGCTAAACGTAACTGA -> GCGGCTAAACGTAACTGAG
TGCGGTCGTATCGATGGGG -> GCGGTCGTATCGATGGGGA
TGCTAAAACAGACAAGTGA -> GCTAAAACAGACAAGTGAC
TGCTATAGCAGCCCCGAGA -> GCTATAGCAGCCCCGAGAT
TGCTCCGCCCGTTTTCCGG -> GCTCCGCCCGTTTTCCGGG
TGCTCGCAATCGTACTGTG -> GCTCGCAATCGTACTGTGT
TGCTGCATGAACTCGTGCC -> GCTGCATGAACTCGTGCCT
TGCTGCATGATGGGGAATG -> GCTGCATGATGGGGAATGC
TGCTGCGGCGACTGTGCAA -> GCTGCGGCGACTGTGCAAG
TGCTTCGAATGAGACAGAG -> GCTTCGAATGAGACAGAGA
TGGAATGCCTCACAGTTAG -> GGAATGCCTCACAGTTAGA
TGGACGTACTGTTGACAAT -> GGACGTACTGTTGACAATT
TGGACTGTGCAAGGACGAT -> GGACTGTGCAAGGACGATC
TGGACTTATATTCTTAACC -> GGACTTATATTCTTAACCA
TGGAGAGAATTGGACTTAT -> GGAGAGAATTGGACTTATA
TGGAGCTGAGCCTGGGGAT -> GGAGCTGAGCCTGGGGATT
TGGAGGGCGGCTGTTCGGC -> GGAGGGCGGCTGTTCGGCA
TGGCAGCCCGCATTCACCT -> GGCAGCCCGCATTCACCTC
TGGCCCTGTGACCACTTAG -> GGCCCTGTGACCACTTAGT
TGGCCGCACGCTACATTTA -> GGCCGCACGCTACATTTAC
TGGCTATCCTTTGCATGGA -> GGCTATCCTTTGCATGGAG
TGGCTGGACGTACTGTTGA -> GGCTGGACGTACTGTTGAC
TGGGACGGTTCGGTCAAAG -> GGGACGGTTCGGTCAAAGA
TGGGAGAGCTCACTATATA -> GGGAGAGCTCACTATATAT
TGGGATCATGTATAACTAG -> GGGATCATGTATAACTAGG
TGGGCGAAATGAGTCTCGA -> GGGCGAAATGAGTCTCGAA
TGGGGAAGCAACACCTGCC -> GGGGAAGCAACACCTGCCT
TGGGGAATGCCGCATGTCG -> GGGGAATGCCGCATGTCGA
TGGGGATTAGCGAGTGGGT -> GGGGATTAGCGAGTGGGTA
TGGGGTCTAGCAGAAGCGC -> GGGGTCTAGCAGAAGCGCG
TGGGTATCCAAATGTGATC -> GGGTATCCAAATGTGATCC
TGGGTCGTAGAGCTGGCCG -> GGGTCGTAGAGCTGGCCGC
TGGTCACTCTAACATTGGC -> GGTCACTCTAACATTGGCC
TGGTCCGTTCCGGCAGACG -> GGTCCGTTCCGGCAGACGG
TGGTCTGCCCTTACTCGAT -> GGTCTGCCCTTACTCGATT
TGGTGACGACTGCAGACGC -> GGTGACGACTGCAGACGCG
TGGTGCATTTGTTTAGTAA -> GGTGCATTTGTTTAGTAAG
TGGTGGGAGAGCTCACTAT -> GGTGGGAGAGCTCACTATA
TGGTGTCGACCAACGCCAT -> GGTGTCGACCAACGCCATT
TGGTTAATTCTTCGCGGCG -> GGTTAATTCTTCGCGGCGA
TGTACCTTTTACTTGTTCG -> GTACCTTTTACTTGTTCGC
TGTACGCACTCCGTGAAGC -> GTACGCACTCCGTGAAGCC
TGTAGGACAAGCTCCACAC -> GTAGGACAAGCTCCACACA
TGTATAACTAGGGGTTTGC -> GTATAACTAGGGGTTTGCA
TGTATAATCTTTTAGACAA -> GTATAATCTTTTAGACAAC
TGTCCCCGCACGGATGGTT -> GTCCCCGCACGGATGGTTA
TGTCGACCAACGCCATTAC -> GTCGACCAACGCCATTACG
TGTCGAGGGCTGTCGGTCG -> GTCGAGGGCTGTCGGTCGT
TGTCGATTTCCTGCTAAAA -> GTCGATTTCCTGCTAAAAC
TGTCGGTCGTCCACTTTAC -> GTCGGTCGTCCACTTTACC
TGTCGTGGTGGGAGAGCTC -> GTCGTGGTGGGAGAGCTCA
TGTCTAACGGGATCGGATC -> GTCTAACGGGATCGGATCG
TGTCTGATGCCGGAAAACG -> GTCTGATGCCGGAAAACGA
TGTGACCACTTAGTTACAC -> GTGACCACTTAGTTACACA
TGTGATCCGTTAGAACGGA -> GTGATCCGTTAGAACGGAG
TGTGCAAGGACGATCCAGA -> GTGCAAGGACGATCCAGAC
TGTGCAAGGACGATCCCGT -> GTGCAAGGACGATCCCGTG,GTGCAAGGACGATCCCGTT
TGTGCAAGGACGATCCGCT -> GTGCAAGGACGATCCGCTA
TGTGGACTGTGCAAGGACG -> GTGGACTGTGCAAGGACGA
TGTGTAGGACAAGCTCCAC -> GTGTAGGACAAGCTCCACA
TGTGTCTAACGGGATCGGA -> GTGTCTAACGGGATCGGAT
TGTTAACACGCCTATTGTC -> GTTAACACGCCTATTGTCT
TGTTACTACTCGGCGCTGA -> GTTACTACTCGGCGCTGAA
TGTTCGCCGTGTTAACACG -> GTTCGCCGTGTTAACACGC
TGTTCGGCAGAGGAAGGGT -> GTTCGGCAGAGGAAGGGTC
TGTTGACAATTTCTCTTAT -> GTTGACAATTTCTCTTATG
TGTTTAGTAAGCCCTGTTA -> GTTTAGTAAGCCCTGTTAC
TTAACAAGTCCGGATATGG -> TAACAAGTCCGGATATGGA
TTAACACGCCTATTGTCTG -> TAACACGCCTATTGTCTGA
TTAACCACGCGCGTATCGT -> TAACCACGCGCGTATCGTG
TTAACCTCGTCCCCAAGCA -> TAACCTCGTCCCCAAGCAC
TTAAGACTTGAAGCCAACC -> TAAGACTTGAAGCCAACCA
TTAATCCACGGTTATTAAC -> TAATCCACGGTTATTAACA
TTAATGCGACTTTTCCTAT -> TAATGCGACTTTTCCTATC
TTAATGGAATGCCTCACAG -> TAATGGAATGCCTCACAGT
TTAATTCTTCGCGGCGAAC -> TAATTCTTCGCGGCGAACT
TTACACATCGACTCCCGGC -> TACACATCGACTCCCGGCT
TTACCTTCGGAACAAGTTG -> TACCTTCGGAACAAGTTGA
TTACGACGGTAAATCAAAA -> TACGACGGTAAATCAAAAT
TTACGGACTGTGCAAGGAC -> TACGGACTGTGCAAGGACG
TTACTACTCGGCGCTGAAG -> TACTACTCGGCGCTGAAGT
TTACTCGATTTTCTAATGC -> TACTCGATTTTCTAATGCC
TTACTCTTCCGGCCGTAAG -> TACTCTTCCGGCCGTAAGC
TTACTTGTTCGCCGTGTTA -> TACTTGTTCGCCGTGTTAA
TTAGAACCCTTCTGCGGCT -> TAGAACCCTTCTGCGGCTA
TTAGAACGGAGCATTATTA -> TAGAACGGAGCATTATTAG
TTAGAACGTTCCTAACTAA -> TAGAACGTTCCTAACTAAT
TTAGACAACCCTTCAGAAA -> TAGACAACCCTTCAGAAAC
TTAGATATGAGTTTGCATT -> TAGATATGAGTTTGCATTC
TTAGCGAGTGGGTATCCAA -> TAGCGAGTGGGTATCCAAA
TTAGCTCACGTGCTGCATG -> TAGCTCACGTGCTGCATGA
TTAGTAAGCCCTGTTACTA -> TAGTAAGCCCTGTTACTAC
TTAGTAGAAATTGACAGGA -> TAGTAGAAATTGACAGGAG
TTAGTCAGGGAGGGCGCTA -> TAGTCAGGGAGGGCGCTAC
TTAGTGATGCCTCGTCAGA -> TAGTGATGCCTCGTCAGAA
TTAGTTACACATCGACTCC -> TAGTTACACATCGACTCCC
TTATAAACAGGGTAGCGCT -> TATAAACAGGGTAGCGCTT
TTATATTCTTAACCACGCG -> TATATTCTTAACCACGCGC
TTATCTGCTCGCAATCGTA -> TATCTGCTCGCAATCGTAC
TTATGGGACGGTTCGGTCA -> TATGGGACGGTTCGGTCAA
TTATTAACAAGTCCGGATA -> TATTAACAAGTCCGGATAT
TTATTAGTAGAAATTGACA -> TATTAGTAGAAATTGACAG
TTATTATTCATAGACTGGC -> TATTATTCATAGACTGGCT
TTATTCATAGACTGGCTAT -> TATTCATAGACTGGCTATC
TTATTCCCCGATCGTTTAT -> TATTCCCCGATCGTTTATA
TTATTTCCTGGTCTGCCCT -> TATTTCCTGGTCTGCCCTT
TTCACATGCGAAAGAAGAT -> TCACATGCGAAAGAAGATT
TTCACCTCAATCGCAGCGC -> TCACCTCAATCGCAGCGCA
TTCACGCCTCGGGGCCGGC -> TCACGCCTCGGGGCCGGCA
TTCAGAAACGGAAGTGATT -> TCAGAAACGGAAGTGATTG
TTCATAGACTGGCTATCCT -> TCATAGACTGGCTATCCTT
TTCCATTTAGATATGAGTT -> TCCATTTAGATATGAGTTT
TTCCCCGATCGTTTATAAA -> TCCCCGATCGTTTATAAAC
TTCCGGCAGACGGTACGGC -> TCCGGCAGACGGTACGGCA
TTCCGGCAGCCGTACTGCG -> TCCGGCAGCCGTACTGCGA
TTCCGGCCGTAAGCAACAC -> TCCGGCCGTAAGCAACACC
TTCCGGGCTCCAGATTCGA -> TCCGGGCTCCAGATTCGAA
TTCCTAACTAATTGCAAGC -> TCCTAACTAATTGCAAGCA
TTCCTATCGACGGATGAGG -> TCCTATCGACGGATGAGGG
TTCCTCTGAAAAGTGCCGA -> TCCTCTGAAAAGTGCCGAG
TTCCTGCTAAAACAGACAA -> TCCTGCTAAAACAGACAAG
TTCCTGGTCTGCCCTTACT -> TCCTGGTCTGCCCTTACTC
TTCGAATGAGACAGAGAGG -> TCGAATGAGACAGAGAGGT
TTCGAATGGTGACGACTGC -> TCGAATGGTGACGACTGCA
TTCGCATACAGATACCTCC -> TCGCATACAGATACCTCCC
TTCGCCGTGTTAACACGCC -> TCGCCGTGTTAACACGCCT
TTCGCGGCGAACTCGTCCT -> TCGCGGCGAACTCGTCCTT
TTCGGAACAAGTTGACGTA -> TCGGAACAAGTTGACGTAC
TTCGGCAGAGGAAGGGTCT -> TCGGCAGAGGAAGGGTCTC
TTCGGCTCCTGGCTGGACG -> TCGGCTCCTGGCTGGACGT
TTCGGGTCATGCTCCGCCC -> TCGGGTCATGCTCCGCCCG
TTCGGTCAAAGATTAGAAC -> TCGGTCAAAGATTAGAACC
TTCGTCTTCTTATTTCCTG -> TCGTCTTCTTATTTCCTGG
TTCTAATGCCAAGTAGATT -> TCTAATGCCAAGTAGATTA
TTCTCCAACAAACCGCATG -> TCTCCAACAAACCGCATGC
TTCTCCAGCCCTGCCCCCC -> TCTCCAGCCCTGCCCCCCT
TTCTCTTATGGGACGGTTC -> TCTCTTATGGGACGGTTCG
TTCTCTTTCGCATACAGAT -> TCTCTTTCGCATACAGATA
TTCTGCGGCTAAACGTAAC -> TCTGCGGCTAAACGTAACT
TTCTTAACCACGCGCGTAT -> TCTTAACCACGCGCGTATC
TTCTTATTTCCTGGTCTGC -> TCTTATTTCCTGGTCTGCC
TTCTTCGCGGCGAACTCGT -> TCTTCGCGGCGAACTCGTC
TTGAACTTTTTCTCCAGCC -> TGAACTTTTTCTCCAGCCC
TTGAAGCCAACCACAGCTC -> TGAAGCCAACCACAGCTCC
TTGACAATTTCTCTTATGG -> TGACAATTTCTCTTATGGG
TTGACAGGAGGCGCCCGGC -> TGACAGGAGGCGCCCGGCT
TTGACGTACGCATCATACA -> TGACGTACGCATCATACAC
TTGACTACTATATAAAGCT -> TGACTACTATATAAAGCTT
TTGCAAGCAAATTTAATGG -> TGCAAGCAAATTTAATGGA
TTGCAAGCAACACCTGCCT -> TGCAAGCAACACCTGCCTA
TTGCATGGAGCTGAGCCTG -> TGCATGGAGCTGAGCCTGG
TTGCATTCTCCAACAAACC -> TGCATTCTCCAACAAACCG
TTGCCGGTCTAATCACACA -> TGCCGGTCTAATCACACAA
TTGCTTCGAATGAGACAGA -> TGCTTCGAATGAGACAGAG
TTGGACTTATATTCTTAAC -> TGGACTTATATTCTTAACC
TTGGCAGCCCGCATTCACC -> TGGCAGCCCGCATTCACCT
TTGGCCCTGTGACCACTTA -> TGGCCCTGTGACCACTTAG
TTGGGATCATGTATAACTA -> TGGGATCATGTATAACTAG
TTGGGTCGTAGAGCTGGCC -> TGGGTCGTAGAGCTGGCCG
TTGGTGTCGACCAACGCCA -> TGGTGTCGACCAACGCCAT
TTGTACCTTTTACTTGTTC -> TGTACCTTTTACTTGTTCG
TTGTATAATCTTTTAGACA -> TGTATAATCTTTTAGACAA
TTGTCTGATGCCGGAAAAC -> TGTCTGATGCCGGAAAACG
TTGTGGACTGTGCAAGGAC -> TGTGGACTGTGCAAGGACG
TTGTGTAGGACAAGCTCCA -> TGTGTAGGACAAGCTCCAC
TTGTTCGCCGTGTTAACAC -> TGTTCGCCGTGTTAACACG
TTGTTTAGTAAGCCCTGTT -> TGTTTAGTAAGCCCTGTTA
TTTAACCTCGTCCCCAAGC -> TTAACCTCGTCCCCAAGCA
TTTAATGGAATGCCTCACA -> TTAATGGAATGCCTCACAG
TTTACCTTCGGAACAAGTT -> TTACCTTCGGAACAAGTTG
TTTACGGACTGTGCAAGGA -> TTACGGACTGTGCAAGGAC
TTTACTCTTCCGGCCGTAA -> TTACTCTTCCGGCCGTAAG
TTTACTTGTTCGCCGTGTT -> TTACTTGTTCGCCGTGTTA
TTTAGACAACCCTTCAGAA -> TTAGACAACCCTTCAGAAA
TTTAGATATGAGTTTGCAT -> TTAGATATGAGTTTGCATT
TTTAGTAAGCCCTGTTACT -> TTAGTAAGCCCTGTTACTA
TTTAGTCAGGGAGGGCGCT -> TTAGTCAGGGAGGGCGCTA
TTTAGTGATGCCTCGTCAG -> TTAGTGATGCCTCGTCAGA
TTTATAAACAGGGTAGCGC -> TTATAAACAGGGTAGCGCT
TTTCACATGCGAAAGAAGA -> TTCACATGCGAAAGAAGAT
TTTCACGCCTCGGGGCCGG -> TTCACGCCTCGGGGCCGGC
TTTCCATTTAGATATGAGT -> TTCCATTTAGATATGAGTT
TTTCCGGGCTCCAGATTCG -> TTCCGGGCTCCAGATTCGA
TTTCCTATCGACGGATGAG -> TTCCTATCGACGGATGAGG
TTTCCTGCTAAAACAGACA -> TTCCTGCTAAAACAGACAA
TTTCCTGGTCTGCCCTTAC -> TTCCTGGTCTGCCCTTACT
TTTCGCATACAGATACCTC -> TTCGCATACAGATACCTCC
TTTCGGGTCATGCTCCGCC -> TTCGGGTCATGCTCCGCCC
TTTCTAATGCCAAGTAGAT -> TTCTAATGCCAAGTAGATT
TTTCTCCAGCCCTGCCCCC -> TTCTCCAGCCCTGCCCCCC
TTTCTCTTATGGGACGGTT -> TTCTCTTATGGGACGGTTC
TTTCTCTTTCGCATACAGA -> TTCTCTTTCGCATACAGAT
TTTGCAAGCAAATTTAATG -> TTGCAAGCAAATTTAATGG
TTTGCATGGAGCTGAGCCT -> TTGCATGGAGCTGAGCCTG
TTTGCATTCTCCAACAAAC -> TTGCATTCTCCAACAAACC
TTTGCCGGTCTAATCACAC -> TTGCCGGTCTAATCACACA
TTTGGGTCGTAGAGCTGGC -> TTGGGTCGTAGAGCTGGCC
TTTGTACCTTTTACTTGTT -> TTGTACCTTTTACTTGTTC
TTTGTGGACTGTGCAAGGA -> TTGTGGACTGTGCAAGGAC
TTTGTTTAGTAAGCCCTGT -> TTGTTTAGTAAGCCCTGTT
TTTTACTTGTTCGCCGTGT -> TTTACTTGTTCGCCGTGTT
TTTTAGACAACCCTTCAGA -> TTTAGACAACCCTTCAGAA
TTTTAGTCAGGGAGGGCGC -> TTTAGTCAGGGAGGGCGCT
TTTTAGTGATGCCTCGTCA -> TTTAGTGATGCCTCGTCAG
TTTTCCGGGCTCCAGATTC -> TTTCCGGGCTCCAGATTCG
TTTTCCTATCGACGGATGA -> TTTCCTATCGACGGATGAG
TTTTCTAATGCCAAGTAGA -> TTTCTAATGCCAAGTAGAT
TTTTCTCCAGCCCTGCCCC -> TTTCTCCAGCCCTGCCCCC
TTTTCTCTTTCGCATACAG -> TTTCTCTTTCGCATACAGA
TTTTGGGTCGTAGAGCTGG -> TTTGGGTCGTAGAGCTGGC
TTTTGTGGACTGTGCAAGG -> TTTGTGGACTGTGCAAGGA
TTTTTCTCCAGCCCTGCCC -> TTTTCTCCAGCCCTGCCCC
TTTTTCTCTTTCGCATACA -> TTTTCTCTTTCGCATACAG
TTTTTGTGGACTGTGCAAG -> TTTTGTGGACTGTGCAAGG
