AAAACGCTACA -> AAACGCTACAA
AAAAGGAGGCT -> AAAGGAGGCTG
AAAATTGGTCC -> AAATTGGTCCA
AAACAGTAATT -> AACAGTAATTC
AAACATTATTT -> AACATTATTTA
AAACCCAGCTA -> AACCCAGCTAG
AAACCTTGGCT -> AACCTTGGCTA
AAACGCTACAA -> AACGCTACAAG
AAACGGGATTC -> AACGGGATTCC
AAAGAAGATAT -> AAGAAGATATT
AAAGCTTCTAG -> AAGCTTCTAGG
AAAGGAGGCTG -> AAGGAGGCTGG
AAAGGAGGGTA -> AAGGAGGGTAT
AAAGGATATCC -> AAGGATATCCC
AAAGGATCATT -> AAGGATCATTG
AAAGTGCATGT -> AAGTGCATGTA
AAATACGGTTC -> AATACGGTTCA
AAATTAAGCGA -> AATTAAGCGAT
AAATTAGAGTT -> AATTAGAGTTC
AAATTCGTAGA -> AATTCGTAGAG
AAATTGGTCCA -> AATTGGTCCAC
AAATTTCGGTA -> AATTTCGGTAA
AACAAAGTGCA -> ACAAAGTGCAT
AACAACTAAGG -> ACAACTAAGGA
AACACGATATC -> ACACGATATCT
AACAGCGCAAG -> ACAGCGCAAGT
AACAGTAATTC -> ACAGTAATTCA
AACATAGCACT -> ACATAGCACTT
AACATCCGGTA -> ACATCCGGTAT
AACATTATTTA -> ACATTATTTAA
AACCACGCCGC -> ACCACGCCGCC
AACCCAGCTAG -> ACCCAGCTAGA
AACCTGTCTTC -> ACCTGTCTTCG
AACCTTGGCTA -> ACCTTGGCTAC
AACGAGGAAAG -> ACGAGGAAAGG
AACGAGGAGTG -> ACGAGGAGTGA
AACGCACTGAA -> ACGCACTGAAC
AACGCTACAAG -> ACGCTACAAGA
AACGGGATTCC -> ACGGGATTCCC
AACTAAGGACT -> ACTAAGGACTC
AACTCCATATC -> ACTCCATATCC
AACTCGGCTTC -> ACTCGGCTTCA
AACTCTAGGCA -> ACTCTAGGCAC
AACTCTCCTAG -> ACTCTCCTAGA
AACTGAGAACT -> ACTGAGAACTT
AACTGCATGGG -> ACTGCATGGGG
AACTGCTAACG -> ACTGCTAACGC
AACTTAACTCT -> ACTTAACTCTA
AACTTAATATT -> ACTTAATATTC
AACTTATACTC -> ACTTATACTCC
AAGAAACCTTG -> AGAAACCTTGG
AAGAAGATATT -> AGAAGATATTG
AAGACAAAGGA -> AGACAAAGGAG
AAGACCACTAA -> AGACCACTAAT
AAGACCTTCGC -> AGACCTTCGCA
AAGACTGCCCG -> AGACTGCCCGC
AAGAGCTGTAC -> AGAGCTGTACT
AAGAGGAGCGG -> AGAGGAGCGGA
AAGATATTGTC -> AGATATTGTCG
AAGATTAGAGA -> AGATTAGAGAC
AAGCACCGGTA -> AGCACCGGTAA
AAGCATGACTG -> AGCATGACTGT
AAGCCAAAGCT -> AGCCAAAGCTT
AAGCGATATAG -> AGCGATATAGT
AAGCGCCTGAG -> AGCGCCTGAGC
AAGCGTGTTTA -> AGCGTGTTTAC
AAGCTGGGCGA -> AGCTGGGCGAG
AAGCTTCTAGG -> AGCTTCTAGGT
AAGGACTCGAT -> AGGACTCGATA
AAGGAGACCGG -> AGGAGACCGGA
AAGGAGGCTGG -> AGGAGGCTGGA
AAGGAGGGTAT -> AGGAGGGTATG
AAGGATAAGAG -> AGGATAAGAGC
AAGGATATCCC -> AGGATATCCCT
AAGGATCATTG -> AGGATCATTGG
AAGGTTCAATG -> AGGTTCAATGC
AAGTAAACAGT -> AGTAAACAGTA
AAGTAATCGAT -> AGTAATCGATG
AAGTACTACAG -> AGTACTACAGT
AAGTCATAGGC -> AGTCATAGGCT
AAGTCGAAATA -> AGTCGAAATAC
AAGTGCATGTA -> AGTGCATGTAC
AAGTGCTCACA -> AGTGCTCACAT
AAGTGCTCATT -> AGTGCTCATTC
AAGTGTGTACG -> AGTGTGTACGT
AAGTTGTATGA -> AGTTGTATGAG
AATAACAGCGC -> ATAACAGCGCA
AATAATATAGC -> ATAATATAGCT
AATACGGTTCA -> ATACGGTTCAC
AATAGGGAACT -> ATAGGGAACTG
AATAGGTTAGT -> ATAGGTTAGTA
AATAGTCTTTC -> ATAGTCTTTCT
AATATACGTGA -> ATATACGTGAT
AATATAGCTTC -> ATATAGCTTCG
AATATTCGGAC -> ATATTCGGACA
AATCAACGAGG -> ATCAACGAGGA
AATCACAGGAC -> ATCACAGGACG
AATCCTGCACT -> ATCCTGCACTG
AATCGATGTAG -> ATCGATGTAGA
AATCGCCGAAT -> ATCGCCGAATA
AATCGTGCAAG -> ATCGTGCAAGT
AATGAGACTCT -> ATGAGACTCTC
AATGATCCACC -> ATGATCCACCA
AATGCTGGGGC -> ATGCTGGGGCC
AATGGCAATTT -> ATGGCAATTTC
AATTAAGCGAT -> ATTAAGCGATA
AATTAGAGTTC -> ATTAGAGTTCA
AATTCACGTTG -> ATTCACGTTGT
AATTCGACACT -> ATTCGACACTT
AATTCGTAGAG -> ATTCGTAGAGA
AATTCTTGGAG -> ATTCTTGGAGA
AATTGGTCCAC -> ATTGGTCCACT
AATTGTAAGGT -> ATTGTAAGGTT
AATTTCGAAAG -> ATTTCGAAAGG
AATTTCGGTAA -> ATTTCGGTAAC
AATTTCTGGGT -> ATTTCTGGGTA
ACAAAGGAGGG -> CAAAGGAGGGT
ACAAAGTGCAT -> CAAAGTGCATG
ACAACTAAGGA -> CAACTAAGGAC
ACAACTCGGCT -> CAACTCGGCTT
ACAACTGCATG -> CAACTGCATGG
ACAAGACCTTC -> CAAGACCTTCG
ACAAGACTGCC -> CAAGACTGCCC
ACAAGTAATCG -> CAAGTAATCGA
ACACAGTAAAG -> CACAGTAAAGA
ACACATCCGTC -> CACATCCGTCG
ACACGATATCT -> CACGATATCTA
ACACTGATCAT -> CACTGATCATC
ACACTGGCGGC -> CACTGGCGGCC
ACACTTACGTG -> CACTTACGTGG
ACAGACTGTAC -> CAGACTGTACG
ACAGAGAACAT -> CAGAGAACATC
ACAGATTGATA -> CAGATTGATAT
ACAGCGCAAGT -> CAGCGCAAGTG
ACAGCGTAGGT -> CAGCGTAGGTG
ACAGGAATATA -> CAGGAATATAC
ACAGGACGAAG -> CAGGACGAAGC
ACAGGCTGTGG -> CAGGCTGTGGC
ACAGGGCAGAC -> CAGGGCAGACT
ACAGTAAAGAA -> CAGTAAAGAAG
ACAGTAATTCA -> CAGTAATTCAC
ACAGTGAGCTT -> CAGTGAGCTTC
ACAGTGTATGG -> CAGTGTATGGC
ACAGTGTGCCG -> CAGTGTGCCGT
ACATAAGGAGA -> CATAAGGAGAC
ACATAGCACTT -> CATAGCACTTC
ACATCCGGTAT -> CATCCGGTATG
ACATCCGTCGG -> CATCCGTCGGC
ACATCGTGTCA -> CATCGTGTCAT
ACATCTGCGAT -> CATCTGCGATT
ACATGATGACA -> CATGATGACAG
ACATGATTGCA -> CATGATTGCAC
ACATGTCCCCA -> CATGTCCCCAA
ACATTACGTGG -> CATTACGTGGA
ACATTACTGCG -> CATTACTGCGA
ACATTATTTAA -> CATTATTTAAT
ACCAACTCCAT -> CCAACTCCATA
ACCAATCGTGC -> CCAATCGTGCA
ACCACGCCGCC -> CCACGCCGCCG
ACCACTAATAA -> CCACTAATAAC
ACCCACAGTGT -> CCCACAGTGTA
ACCCAGCTAGA -> CCCAGCTAGAC
ACCCCCGGTTC -> CCCCCGGTTCA
ACCGAACAAAG -> CCGAACAAAGT
ACCGAGATAAT -> CCGAGATAATC
ACCGGAATTCT -> CCGGAATTCTT
ACCGGTAAGAG -> CCGGTAAGAGG
ACCGTGACTCA -> CCGTGACTCAC
ACCGTGCAAAC -> CCGTGCAAACC
ACCTCTCTCGA -> CCTCTCTCGAC
ACCTCTTCTGA -> CCTCTTCTGAC
ACCTGCAGTGA -> CCTGCAGTGAG
ACCTGGCCGAT -> CCTGGCCGATA
ACCTGTCTTCG -> CCTGTCTTCGG
ACCTTCCTTCT -> CCTTCCTTCTT
ACCTTCGCAGT -> CCTTCGCAGTC
ACCTTGGCTAC -> CCTTGGCTACT
ACCTTTTCATG -> CCTTTTCATGA
ACGAAGCATGA -> CGAAGCATGAC
ACGAATTGTAA -> CGAATTGTAAG
ACGAGGAAAGG -> CGAGGAAAGGA
ACGAGGAGTGA -> CGAGGAGTGAC
ACGATACTTAG -> CGATACTTAGA
ACGATATCTAC -> CGATATCTACC
ACGCACTGAAC -> CGCACTGAACA
ACGCACTGCTC -> CGCACTGCTCT
ACGCCGCCGGC -> CGCCGCCGGCG
ACGCTACAAGA -> CGCTACAAGAC
ACGCTTAATGG -> CGCTTAATGGC
ACGGATGTTGA -> CGGATGTTGAC
ACGGATTACTC -> CGGATTACTCC
ACGGCCAAGTC -> CGGCCAAGTCG
ACGGCCCTTAT -> CGGCCCTTATC
ACGGGATTCCC -> CGGGATTCCCT
ACGGTCGTGAA -> CGGTCGTGAAG
ACGGTTCACTG -> CGGTTCACTGG
ACGGTTTTTTT -> CGGTTTTTTTT
ACGTAGTTACC -> CGTAGTTACCG
ACGTATACCCA -> CGTATACCCAC
ACGTCGGCCCC -> CGTCGGCCCCT
ACGTCTGTGCA -> CGTCTGTGCAC
ACGTGATGACG -> CGTGATGACGT
ACGTGCCGTCT -> CGTGCCGTCTA
ACGTGGAGTTT -> CGTGGAGTTTA
ACGTGGGCTAA -> CGTGGGCTAAT
ACGTTGTACCC -> CGTTGTACCCC
ACTAAGCTGGG -> CTAAGCTGGGC
ACTAAGGACTC -> CTAAGGACTCG
ACTAATAACAG -> CTAATAACAGC
ACTACAGTGTG -> CTACAGTGTGC
ACTAGAACTTA -> CTAGAACTTAT
ACTAGAGCGTA -> CTAGAGCGTAA
ACTAGGTTTGA -> CTAGGTTTGAT
ACTCAAACGGG -> CTCAAACGGGA
ACTCACAAGTA -> CTCACAAGTAA
ACTCCAACTTA -> CTCCAACTTAA
ACTCCACTCCG -> CTCCACTCCGT
ACTCCATATCC -> CTCCATATCCG
ACTCCGTATAG -> CTCCGTATAGC
ACTCGATACAC -> CTCGATACACA
ACTCGGCTTCA -> CTCGGCTTCAA
ACTCGTACCTC -> CTCGTACCTCT
ACTCTAGGCAC -> CTCTAGGCACA
ACTCTCCTAAG -> CTCTCCTAAGT
ACTCTCCTAGA -> CTCTCCTAGAT
ACTGAACACGA -> CTGAACACGAT
ACTGACGAATT -> CTGACGAATTG
ACTGACTAGAA -> CTGACTAGAAC
ACTGAGAACTT -> CTGAGAACTTA
ACTGATCATCC -> CTGATCATCCT
ACTGATTTTAG -> CTGATTTTAGG
ACTGCATGGGG -> CTGCATGGGGT
ACTGCCCGCAT -> CTGCCCGCATC
ACTGCGAGCGG -> CTGCGAGCGGC
ACTGCTAACGC -> CTGCTAACGCA
ACTGCTCTGGG -> CTGCTCTGGGA
ACTGCTCTGTG -> CTGCTCTGTGT
ACTGGAACTGA -> CTGGAACTGAG
ACTGGCGGCCA -> CTGGCGGCCAA
ACTGGTCATGA -> CTGGTCATGAT
ACTGGTTGCTA -> CTGGTTGCTAA
ACTGTACGGTC -> CTGTACGGTCG
ACTGTAGATAT -> CTGTAGATATT
ACTGTCAAGTA -> CTGTCAAGTAC
ACTGTGGGACC -> CTGTGGGACCG
ACTTAACTCTA -> CTTAACTCTAG
ACTTAATATTC -> CTTAATATTCG
ACTTACGTGGG -> CTTACGTGGGC
ACTTAGAGGAT -> CTTAGAGGATA
ACTTATACTCC -> CTTATACTCCA
ACTTCACACTG -> CTTCACACTGA
ACTTCGTGAGA -> CTTCGTGAGAC
ACTTCTTCGTC -> CTTCTTCGTCC
ACTTGCATACC -> CTTGCATACCG
ACTTGGCGCGG -> CTTGGCGCGGT
ACTTGGGGATG -> CTTGGGGATGA
ACTTGGTACAA -> CTTGGTACAAC
AGAAAATTGGT -> GAAAATTGGTC
AGAAACCTTGG -> GAAACCTTGGC
AGAACAACTAA -> GAACAACTAAG
AGAACATCCGG -> GAACATCCGGT
AGAACTTAACT -> GAACTTAACTC
AGAACTTATAC -> GAACTTATACT
AGAAGATATTG -> GAAGATATTGT
AGAATAGGGAA -> GAATAGGGAAC
AGAATTCGACA -> GAATTCGACAC
AGACAAAGGAG -> GACAAAGGAGG
AGACAGGAATA -> GACAGGAATAT
AGACCACTAAT -> GACCACTAATA
AGACCGGAATT -> GACCGGAATTC
AGACCTGGCCG -> GACCTGGCCGA
AGACCTTCCTT -> GACCTTCCTTC
AGACCTTCGCA -> GACCTTCGCAG
AGACGATACTT -> GACGATACTTA
AGACGCTTAAT -> GACGCTTAATG
AGACGGTTTTT -> GACGGTTTTTT
AGACTAGGTTT -> GACTAGGTTTG
AGACTCTCCTA -> GACTCTCCTAA
AGACTGCCCGC -> GACTGCCCGCA
AGACTGTACGG -> GACTGTACGGT
AGAGAACATCC -> GAGAACATCCG
AGAGACAGGAA -> GAGACAGGAAT
AGAGAGTTTGA -> GAGAGTTTGAG
AGAGCAGACCT -> GAGCAGACCTG
AGAGCGTAAGT -> GAGCGTAAGTG
AGAGCTGTACT -> GAGCTGTACTT
AGAGGAGCGGA -> GAGGAGCGGAC
AGAGGATACGT -> GAGGATACGTA
AGAGTTCACAG -> GAGTTCACAGG
AGAGTTTGAGA -> GAGTTTGAGAA
AGATAAGATTA -> GATAAGATTAG
AGATAATCAAC -> GATAATCAACG
AGATATGCCGA -> GATATGCCGAC
AGATATTGTCG -> GATATTGTCGC
AGATATTGTTA -> GATATTGTTAG
AGATCTAGCGT -> GATCTAGCGTG
AGATGTAGCAG -> GATGTAGCAGA
AGATTAGAGAC -> GATTAGAGACA
AGATTGATATG -> GATTGATATGA
AGATTGCCATA -> GATTGCCATAG
AGCAACCACGC -> GCAACCACGCC
AGCACCGGTAA -> GCACCGGTAAG
AGCACTTCGTG -> GCACTTCGTGA
AGCAGACCTGG -> GCAGACCTGGC
AGCAGATCTAG -> GCAGATCTAGC
AGCATGACTGT -> GCATGACTGTG
AGCCAAAGCTT -> GCCAAAGCTTC
AGCCACATCTG -> GCCACATCTGC
AGCCACTTGGC -> GCCACTTGGCG
AGCCCTATCAC -> GCCCTATCACT
AGCCGAAGAAA -> GCCGAAGAAAC
AGCGATATAGT -> GCGATATAGTT
AGCGCAAGTGC -> GCGCAAGTGCT
AGCGCCTGAGC -> GCGCCTGAGCT
AGCGGACAAGA -> GCGGACAAGAC
AGCGGCCCCGG -> GCGGCCCCGGC
AGCGTAAGTGT -> GCGTAAGTGTG
AGCGTAGGTGT -> GCGTAGGTGTA
AGCGTGAGGAC -> GCGTGAGGACA
AGCGTGTTTAC -> GCGTGTTTACT
AGCTAGACGAT -> GCTAGACGATA
AGCTAGGGAGT -> GCTAGGGAGTA
AGCTCCCGGTC -> GCTCCCGGTCA
AGCTGGGCGAG -> GCTGGGCGAGT
AGCTGTACTTC -> GCTGTACTTCT
AGCTGTTTCGC -> GCTGTTTCGCA
AGCTTCGGTAA -> GCTTCGGTAAT
AGCTTCTAACA -> GCTTCTAACAT
AGCTTCTAGGT -> GCTTCTAGGTT
AGGAAAGGATC -> GGAAAGGATCA
AGGAATATACG -> GGAATATACGT
AGGACAGATTG -> GGACAGATTGA
AGGACATGTCC -> GGACATGTCCC
AGGACGAAGCA -> GGACGAAGCAT
AGGACTCGATA -> GGACTCGATAC
AGGACTGATTT -> GGACTGATTTT
AGGAGACCGGA -> GGAGACCGGAA
AGGAGCGGACA -> GGAGCGGACAA
AGGAGGCTGGA -> GGAGGCTGGAT
AGGAGGGTATG -> GGAGGGTATGT
AGGAGTGACAA -> GGAGTGACAAC
AGGATAAGAGC -> GGATAAGAGCT
AGGATACGTAT -> GGATACGTATA
AGGATATCCCT -> GGATATCCCTG
AGGATCATTGG -> GGATCATTGGC
AGGCACACATC -> GGCACACATCC
AGGCACGGATT -> GGCACGGATTA
AGGCATGTTCT -> GGCATGTTCTG
AGGCCGCACGC -> GGCCGCACGCA
AGGCTGGAGAT -> GGCTGGAGATA
AGGCTGGATTA -> GGCTGGATTAA
AGGCTGTGGCG -> GGCTGTGGCGA
AGGGAACTGCT -> GGGAACTGCTA
AGGGAGTACTT -> GGGAGTACTTC
AGGGCAGACTA -> GGGCAGACTAG
AGGGCGGGTGC -> GGGCGGGTGCA
AGGGGCCTACT -> GGGGCCTACTA
AGGGTACATGA -> GGGTACATGAT
AGGGTATGTTG -> GGGTATGTTGA
AGGTGTAAAAC -> GGTGTAAAACG
AGGTTACTGTA -> GGTTACTGTAG
AGGTTAGTAGG -> GGTTAGTAGGA
AGGTTCAATGC -> GGTTCAATGCT
AGGTTTATATC -> GGTTTATATCG
AGGTTTGATTG -> GGTTTGATTGT
AGTAAACAGTA -> GTAAACAGTAA
AGTAAAGAAGA -> GTAAAGAAGAT
AGTAAATTAAG -> GTAAATTAAGC
AGTAAATTTCG -> GTAAATTTCGG
AGTAATCGATG -> GTAATCGATGT
AGTAATTCACG -> GTAATTCACGT
AGTACATTACG -> GTACATTACGT
AGTACTACAGT -> GTACTACAGTG
AGTACTTCACA -> GTACTTCACAC
AGTAGATATGC -> GTAGATATGCC
AGTAGGACATG -> GTAGGACATGT
AGTCAATGATC -> GTCAATGATCC
AGTCATAGGCT -> GTCATAGGCTG
AGTCGAAATAC -> GTCGAAATACG
AGTCTTTCTCC -> GTCTTTCTCCG
AGTGAACGAGG -> GTGAACGAGGA
AGTGAATAGGT -> GTGAATAGGTT
AGTGACAACTG -> GTGACAACTGC
AGTGAGCTTCT -> GTGAGCTTCTA
AGTGAGTACAT -> GTGAGTACATT
AGTGCATGTAC -> GTGCATGTACA
AGTGCTCACAT -> GTGCTCACATA
AGTGCTCATTC -> GTGCTCATTCT
AGTGTATGGCT -> GTGTATGGCTG
AGTGTGCCGTC -> GTGTGCCGTCC
AGTGTGTACGT -> GTGTGTACGTC
AGTTACCGTGA -> GTTACCGTGAC
AGTTCACAGGG -> GTTCACAGGGC
AGTTCCCTACA -> GTTCCCTACAT
AGTTGTATGAG -> GTTGTATGAGC
AGTTGTTTAGC -> GTTGTTTAGCC
AGTTTAAGCAC -> GTTTAAGCACC
AGTTTGAGAAT -> GTTTGAGAATA
ATAACAGCGCA -> TAACAGCGCAA
ATAAGAGCTGT -> TAAGAGCTGTA
ATAAGATTAGA -> TAAGATTAGAG
ATAAGGAGACC -> TAAGGAGACCG
ATAAGTAAACA -> TAAGTAAACAG
ATAATATAGCT -> TAATATAGCTT
ATAATCAACGA -> TAATCAACGAG
ATACACAGTAA -> TACACAGTAAA
ATACCCACAGT -> TACCCACAGTG
ATACCGAGATA -> TACCGAGATAA
ATACGGTTCAC -> TACGGTTCACT
ATACGTATACC -> TACGTATACCC
ATACGTGATGA -> TACGTGATGAC
ATACTCCAACT -> TACTCCAACTT
ATACTTAGAGG -> TACTTAGAGGA
ATAGCACTTCG -> TAGCACTTCGT
ATAGCCACTTG -> TAGCCACTTGG
ATAGCTTCGGT -> TAGCTTCGGTA
ATAGGCTGGAG -> TAGGCTGGAGA
ATAGGGAACTG -> TAGGGAACTGC
ATAGGTTAGTA -> TAGGTTAGTAG
ATAGTAGATAT -> TAGTAGATATG
ATAGTCTTTCT -> TAGTCTTTCTC
ATAGTTCCCTA -> TAGTTCCCTAC
ATAGTTGTTTA -> TAGTTGTTTAG
ATATACGTGAT -> TATACGTGATG
ATATAGCTTCG -> TATAGCTTCGG
ATATAGTTGTT -> TATAGTTGTTT
ATATATTGAGG -> TATATTGAGGG
ATATCCCTGAC -> TATCCCTGACC
ATATCCGCGGC -> TATCCGCGGCC
ATATCGACGTC -> TATCGACGTCG
ATATCTACCAA -> TATCTACCAAC
ATATGAGAGCA -> TATGAGAGCAG
ATATGCCGACG -> TATGCCGACGG
ATATTCGGACA -> TATTCGGACAG
ATATTGAGGGG -> TATTGAGGGGC
ATATTGTCGCC -> TATTGTCGCCA
ATATTGTTAGC -> TATTGTTAGCT
ATCAACGAGGA -> TCAACGAGGAG
ATCACAGGACG -> TCACAGGACGA
ATCACTTGGTA -> TCACTTGGTAC
ATCATCCTGGC -> TCATCCTGGCC
ATCATTGGCGT -> TCATTGGCGTA
ATCCAAACATT -> TCCAAACATTA
ATCCAAATTAG -> TCCAAATTAGA
ATCCACCAATC -> TCCACCAATCG
ATCCCTGACCG -> TCCCTGACCGT
ATCCGCGGCCC -> TCCGCGGCCCA
ATCCGGTATGT -> TCCGGTATGTG
ATCCGTCGGCT -> TCCGTCGGCTC
ATCCTCGGTGG -> TCCTCGGTGGT
ATCCTGCACTG -> TCCTGCACTGA
ATCCTGGCCAA -> TCCTGGCCAAG
ATCGACGTCGG -> TCGACGTCGGC
ATCGATGTAGA -> TCGATGTAGAA
ATCGCCGAATA -> TCGCCGAATAA
ATCGTGCAAGT -> TCGTGCAAGTG
ATCGTGTCATG -> TCGTGTCATGC
ATCTACCAACT -> TCTACCAACTC
ATCTACCTCTC -> TCTACCTCTCT
ATCTAGCGTGA -> TCTAGCGTGAG
ATCTGCGATTG -> TCTGCGATTGG
ATGACAGACTG -> TGACAGACTGT
ATGACATGATG -> TGACATGATGA
ATGACGTGCCG -> TGACGTGCCGT
ATGACTGTGGG -> TGACTGTGGGA
ATGAGAAAATT -> TGAGAAAATTG
ATGAGACTCTC -> TGAGACTCTCC
ATGAGAGCAGA -> TGAGAGCAGAC
ATGAGCCGAAG -> TGAGCCGAAGA
ATGAGGGCGGG -> TGAGGGCGGGT
ATGATCCACCA -> TGATCCACCAA
ATGATGACAGA -> TGATGACAGAC
ATGATGACATG -> TGATGACATGA
ATGATGCGTGA -> TGATGCGTGAA
ATGATTGCACG -> TGATTGCACGT
ATGCATTCATC -> TGCATTCATCC
ATGCCGACGGC -> TGCCGACGGCC
ATGCGTGAAGA -> TGCGTGAAGAC
ATGCTGGGGCC -> TGCTGGGGCCA
ATGGCAATTTC -> TGGCAATTTCG
ATGGCTGCTTA -> TGGCTGCTTAG
ATGTACAGCGT -> TGTACAGCGTA
ATGTAGAACAA -> TGTAGAACAAC
ATGTAGAATTC -> TGTAGAATTCG
ATGTAGCAGAT -> TGTAGCAGATC
ATGTCCCCAAT -> TGTCCCCAATA
ATGTGCAGGCC -> TGTGCAGGCCG
ATGTTCTGCTC -> TGTTCTGCTCG
ATGTTGACATT -> TGTTGACATTA
ATGTTGACTGG -> TGTTGACTGGT
ATTAAGCGATA -> TTAAGCGATAT
ATTAATCACAG -> TTAATCACAGG
ATTACGTGGAG -> TTACGTGGAGT
ATTACTCCACT -> TTACTCCACTC
ATTACTGCGAG -> TTACTGCGAGC
ATTAGAGACAG -> TTAGAGACAGG
ATTAGAGTTCA -> TTAGAGTTCAC
ATTATTTAATT -> TTATTTAATTT
ATTCACGTTGT -> TTCACGTTGTA
ATTCATCCTCG -> TTCATCCTCGG
ATTCCCTTCAC -> TTCCCTTCACT
ATTCGACACTT -> TTCGACACTTA
ATTCGGACAGG -> TTCGGACAGGC
ATTCGTAGAGA -> TTCGTAGAGAG
ATTCTCCCAGA -> TTCTCCCAGAT
ATTCTTGGAGA -> TTCTTGGAGAC
ATTGAGGGGCC -> TTGAGGGGCCT
ATTGATATGAG -> TTGATATGAGA
ATTGCACGTAG -> TTGCACGTAGT
ATTGCCATAGT -> TTGCCATAGTA
ATTGGCAAGGA -> TTGGCAAGGAT
ATTGGCGTAGG -> TTGGCGTAGGC
ATTGGTCCACT -> TTGGTCCACTC
ATTGTAAGGTT -> TTGTAAGGTTC
ATTGTCGCCAC -> TTGTCGCCACA
ATTGTGTCCAC -> TTGTGTCCACT
ATTGTTAGCTG -> TTGTTAGCTGT
ATTGTTTGTAC -> TTGTTTGTACG
ATTTAATTTCT -> TTTAATTTCTG
ATTTCGAAAGG -> TTTCGAAAGGA
ATTTCGGTAAC -> TTTCGGTAACC
ATTTCTGGGTA -> TTTCTGGGTAT
ATTTTAGGCAT -> TTTTAGGCATG
CAAACATTATT -> AAACATTATTT
CAAACCCAGCT -> AAACCCAGCTA
CAAACGGGATT -> AAACGGGATTC
CAAAGCTTCTA -> AAAGCTTCTAG
CAAAGGAGGGT -> AAAGGAGGGTA
CAAAGTGCATG -> AAAGTGCATGT
CAAATTAGAGT -> AAATTAGAGTT
CAAATTCGTAG -> AAATTCGTAGA
CAACCACGCCG -> AACCACGCCGC
CAACGAGGAGT -> AACGAGGAGTG
CAACTAAGGAC -> AACTAAGGACT
CAACTCCATAT -> AACTCCATATC
CAACTCGGCTT -> AACTCGGCTTC
CAACTCTCCTA -> AACTCTCCTAG
CAACTGCATGG -> AACTGCATGGG
CAACTTAATAT -> AACTTAATATT
CAAGACCTTCG -> AAGACCTTCGC
CAAGACTGCCC -> AAGACTGCCCG
CAAGCCAAAGC -> AAGCCAAAGCT
CAAGGATAAGA -> AAGGATAAGAG
CAAGTAATCGA -> AAGTAATCGAT
CAAGTACTACA -> AAGTACTACAG
CAAGTCGAAAT -> AAGTCGAAATA
CAAGTGCTCAC -> AAGTGCTCACA
CAAGTGCTCAT -> AAGTGCTCATT
CAATAGTCTTT -> AATAGTCTTTC
CAATCGTGCAA -> AATCGTGCAAG
CAATGAGACTC -> AATGAGACTCT
CAATGATCCAC -> AATGATCCACC
CAATGCTGGGG -> AATGCTGGGGC
CAATTTCGAAA -> AATTTCGAAAG
CACAAGTAATC -> ACAAGTAATCG
CACACATCCGT -> ACACATCCGTC
CACACTGATCA -> ACACTGATCAT
CACACTGGCGG -> ACACTGGCGGC
CACAGGACGAA -> ACAGGACGAAG
CACAGGGCAGA -> ACAGGGCAGAC
CACAGTAAAGA -> ACAGTAAAGAA
CACAGTGAGCT -> ACAGTGAGCTT
CACAGTGTATG -> ACAGTGTATGG
CACATAAGGAG -> ACATAAGGAGA
CACATCCGTCG -> ACATCCGTCGG
CACATCTGCGA -> ACATCTGCGAT
CACCAATCGTG -> ACCAATCGTGC
CACCGGTAAGA -> ACCGGTAAGAG
CACCTGCAGTG -> ACCTGCAGTGA
CACGATATCTA -> ACGATATCTAC
CACGCACTGCT -> ACGCACTGCTC
CACGCCGCCGG -> ACGCCGCCGGC
CACGGATTACT -> ACGGATTACTC
CACGGCCCTTA -> ACGGCCCTTAT
CACGTAGTTAC -> ACGTAGTTACC
CACGTTGTACC -> ACGTTGTACCC
CACTAATAACA -> ACTAATAACAG
CACTCAAACGG -> ACTCAAACGGG
CACTCCGTATA -> ACTCCGTATAG
CACTGAACACG -> ACTGAACACGA
CACTGACGAAT -> ACTGACGAATT
CACTGACTAGA -> ACTGACTAGAA
CACTGATCATC -> ACTGATCATCC
CACTGCTCTGT -> ACTGCTCTGTG
CACTGGCGGCC -> ACTGGCGGCCA
CACTGGTTGCT -> ACTGGTTGCTA
CACTGTCAAGT -> ACTGTCAAGTA
CACTTACGTGG -> ACTTACGTGGG
CACTTCGTGAG -> ACTTCGTGAGA
CACTTGCATAC -> ACTTGCATACC
CACTTGGCGCG -> ACTTGGCGCGG
CACTTGGGGAT -> ACTTGGGGATG
CACTTGGTACA -> ACTTGGTACAA
CAGACCTGGCC -> AGACCTGGCCG
CAGACGCTTAA -> AGACGCTTAAT
CAGACTAGGTT -> AGACTAGGTTT
CAGACTGTACG -> AGACTGTACGG
CAGAGAACATC -> AGAGAACATCC
CAGATCTAGCG -> AGATCTAGCGT
CAGATTGATAT -> AGATTGATATG
CAGATTGCCAT -> AGATTGCCATA
CAGCCACATCT -> AGCCACATCTG
CAGCGCAAGTG -> AGCGCAAGTGC
CAGCGTAGGTG -> AGCGTAGGTGT
CAGCTAGACGA -> AGCTAGACGAT
CAGGAATATAC -> AGGAATATACG
CAGGACGAAGC -> AGGACGAAGCA
CAGGACTGATT -> AGGACTGATTT
CAGGCCGCACG -> AGGCCGCACGC
CAGGCTGTGGC -> AGGCTGTGGCG
CAGGGCAGACT -> AGGGCAGACTA
CAGGGTACATG -> AGGGTACATGA
CAGTAAAGAAG -> AGTAAAGAAGA
CAGTAAATTAA -> AGTAAATTAAG
CAGTAATTCAC -> AGTAATTCACG
CAGTCAATGAT -> AGTCAATGATC
CAGTGAACGAG -> AGTGAACGAGG
CAGTGAGCTTC -> AGTGAGCTTCT
CAGTGAGTACA -> AGTGAGTACAT
CAGTGTATGGC -> AGTGTATGGCT
CAGTGTGCCGT -> AGTGTGCCGTC
CATAAGGAGAC -> ATAAGGAGACC
CATACCGAGAT -> ATACCGAGATA
CATAGCACTTC -> ATAGCACTTCG
CATAGGCTGGA -> ATAGGCTGGAG
CATAGTAGATA -> ATAGTAGATAT
CATATCCGCGG -> ATATCCGCGGC
CATCCAAATTA -> ATCCAAATTAG
CATCCGGTATG -> ATCCGGTATGT
CATCCGTCGGC -> ATCCGTCGGCT
CATCCTCGGTG -> ATCCTCGGTGG
CATCCTGGCCA -> ATCCTGGCCAA
CATCGTGTCAT -> ATCGTGTCATG
CATCTGCGATT -> ATCTGCGATTG
CATGACTGTGG -> ATGACTGTGGG
CATGAGAAAAT -> ATGAGAAAATT
CATGATGACAG -> ATGATGACAGA
CATGATGCGTG -> ATGATGCGTGA
CATGATTGCAC -> ATGATTGCACG
CATGCATTCAT -> ATGCATTCATC
CATGGGGTGTT -> 
CATGTACAGCG -> ATGTACAGCGT
CATGTCCCCAA -> ATGTCCCCAAT
CATGTTCTGCT -> ATGTTCTGCTC
CATTACGTGGA -> ATTACGTGGAG
CATTACTGCGA -> ATTACTGCGAG
CATTATTTAAT -> ATTATTTAATT
CATTCATCCTC -> ATTCATCCTCG
CATTCTCCCAG -> ATTCTCCCAGA
CATTGGCGTAG -> ATTGGCGTAGG
CCAAACATTAT -> CAAACATTATT
CCAAAGCTTCT -> CAAAGCTTCTA
CCAAATTAGAG -> CAAATTAGAGT
CCAAATTCGTA -> CAAATTCGTAG
CCAACTCCATA -> CAACTCCATAT
CCAACTTAATA -> CAACTTAATAT
CCAAGCCAAAG -> CAAGCCAAAGC
CCAAGTCGAAA -> CAAGTCGAAAT
CCAATAGTCTT -> CAATAGTCTTT
CCAATCGTGCA -> CAATCGTGCAA
CCACACTGGCG -> CACACTGGCGG
CCACAGTGAGC -> CACAGTGAGCT
CCACAGTGTAT -> CACAGTGTATG
CCACATCTGCG -> CACATCTGCGA
CCACCAATCGT -> CACCAATCGTG
CCACCTGCAGT -> CACCTGCAGTG
CCACGCCGCCG -> CACGCCGCCGG
CCACTAATAAC -> CACTAATAACA
CCACTCAAACG -> CACTCAAACGG
CCACTCCGTAT -> CACTCCGTATA
CCACTTGGCGC -> CACTTGGCGCG
CCACTTGGGGA -> CACTTGGGGAT
CCAGATTGCCA -> CAGATTGCCAT
CCAGCCACATC -> CAGCCACATCT
CCAGCTAGACG -> CAGCTAGACGA
CCAGGACTGAT -> CAGGACTGATT
CCATAGTAGAT -> CATAGTAGATA
CCATATCCGCG -> CATATCCGCGG
CCCAATAGTCT -> CCAATAGTCTT
CCCACAGTGAG -> CCACAGTGAGC
CCCACAGTGTA -> CCACAGTGTAT
CCCACCTGCAG -> CCACCTGCAGT
CCCAGATTGCC -> CCAGATTGCCA
CCCAGCCACAT -> CCAGCCACATC
CCCAGCTAGAC -> CCAGCTAGACG
CCCCAATAGTC -> CCCAATAGTCT
CCCCCGGTTCA -> CCCCGGTTCAG
CCCCGGCGCAG -> CCCGGCGCAGT
CCCCGGTTCAG -> CCCGGTTCAGG
CCCCTACTAGA -> CCCTACTAGAG
CCCGCATCCAA -> CCGCATCCAAA
CCCGGCGCAGT -> CCGGCGCAGTA
CCCGGTCAGAC -> CCGGTCAGACG
CCCGGTTCAGG -> CCGGTTCAGGG
CCCTACATCGT -> CCTACATCGTG
CCCTACTAGAG -> CCTACTAGAGC
CCCTATCACTT -> CCTATCACTTG
CCCTGACCGTG -> CCTGACCGTGC
CCCTTATCCAA -> CCTTATCCAAA
CCCTTCACTGT -> CCTTCACTGTC
CCGAACAAAGT -> CGAACAAAGTG
CCGAAGAAACC -> CGAAGAAACCT
CCGAATAATAT -> CGAATAATATA
CCGACGGCCAA -> CGACGGCCAAG
CCGAGATAATC -> CGAGATAATCA
CCGATAGTTCC -> CGATAGTTCCC
CCGCACGCACT -> CGCACGCACTG
CCGCATCCAAA -> CGCATCCAAAT
CCGCCGGCGTT -> CGCCGGCGTTC
CCGCGGCCCAC -> CGCGGCCCACC
CCGGAATTCTT -> CGGAATTCTTG
CCGGCGCAGTA -> CGGCGCAGTAA
CCGGCGTTCTA -> CGGCGTTCTAA
CCGGTAAGAGG -> CGGTAAGAGGA
CCGGTATGTGC -> CGGTATGTGCA
CCGGTCAGACG -> CGGTCAGACGC
CCGGTTCAGGG -> CGGTTCAGGGT
CCGGTTGATAT -> CGGTTGATATA
CCGTATAGCCA -> CGTATAGCCAC
CCGTCCCAGCC -> CGTCCCAGCCA
CCGTCGGCTCT -> CGTCGGCTCTT
CCGTCGTATGA -> CGTCGTATGAT
CCGTCTACAGA -> CGTCTACAGAG
CCGTGACTCAC -> CGTGACTCACA
CCGTGCAAACC -> CGTGCAAACCC
CCTAAGTTGTA -> CTAAGTTGTAT
CCTACATCGTG -> CTACATCGTGT
CCTACTAAGCT -> CTACTAAGCTG
CCTACTAGAGC -> CTACTAGAGCG
CCTAGATGTAG -> CTAGATGTAGC
CCTATCACTTG -> CTATCACTTGG
CCTATTGTGTC -> CTATTGTGTCC
CCTCGGTGGTC -> CTCGGTGGTCT
CCTCTCTCGAC -> CTCTCTCGACT
CCTCTTCTGAC -> CTCTTCTGACC
CCTGACCGTGC -> CTGACCGTGCA
CCTGAGCTCCC -> CTGAGCTCCCG
CCTGCACTGAC -> CTGCACTGACG
CCTGCAGTGAG -> CTGCAGTGAGT
CCTGGCCAAGC -> CTGGCCAAGCC
CCTGGCCGATA -> CTGGCCGATAG
CCTGTCTTCGG -> CTGTCTTCGGA
CCTTATCCAAA -> CTTATCCAAAC
CCTTCACTGTC -> CTTCACTGTCA
CCTTCCTTCTT -> CTTCCTTCTTT
CCTTCGCAGTC -> CTTCGCAGTCA
CCTTCTTTGAA -> CTTCTTTGAAG
CCTTGGCTACT -> CTTGGCTACTC
CCTTTTCATGA -> CTTTTCATGAG
CGAAAGGATAT -> GAAAGGATATC
CGAAATACGGT -> GAAATACGGTT
CGAACAAAGTG -> GAACAAAGTGC
CGAAGAAACCT -> GAAGAAACCTT
CGAAGCATGAC -> GAAGCATGACT
CGAATAATATA -> GAATAATATAG
CGAATTGTAAG -> GAATTGTAAGG
CGACACTTACG -> GACACTTACGT
CGACGGCCAAG -> GACGGCCAAGT
CGACGTCGGCC -> GACGTCGGCCC
CGACTGGAACT -> GACTGGAACTG
CGAGATAATCA -> GAGATAATCAA
CGAGCAACCAC -> GAGCAACCACG
CGAGCGGCCCC -> GAGCGGCCCCG
CGAGGAAAGGA -> GAGGAAAGGAT
CGAGGAGTGAC -> GAGGAGTGACA
CGAGTAAATTT -> GAGTAAATTTC
CGATACACAGT -> GATACACAGTA
CGATACTTAGA -> GATACTTAGAG
CGATAGTTCCC -> GATAGTTCCCT
CGATATAGTTG -> GATATAGTTGT
CGATATCTACC -> GATATCTACCA
CGATGTAGAAC -> GATGTAGAACA
CGATTGGCAAG -> GATTGGCAAGG
CGCAAGTGCTC -> GCAAGTGCTCA
CGCAATGAGAC -> GCAATGAGACT
CGCACGCACTG -> GCACGCACTGC
CGCACTGAACA -> GCACTGAACAC
CGCACTGCTCT -> GCACTGCTCTG
CGCAGTAAATT -> GCAGTAAATTA
CGCAGTCAATG -> GCAGTCAATGA
CGCATCCAAAT -> GCATCCAAATT
CGCCACACTGG -> GCCACACTGGC
CGCCGAATAAT -> GCCGAATAATA
CGCCGCCGGCG -> GCCGCCGGCGT
CGCCGGCGTTC -> GCCGGCGTTCT
CGCCTGAGCTC -> GCCTGAGCTCC
CGCGGCCCACC -> GCGGCCCACCT
CGCGGTCTGCC -> GCGGTCTGCCC
CGCTACAAGAC -> GCTACAAGACT
CGCTTAATGGC -> GCTTAATGGCA
CGGAATTCTTG -> GGAATTCTTGG
CGGACAAGACC -> GGACAAGACCT
CGGACAGGCTG -> GGACAGGCTGT
CGGAGCTAGGG -> GGAGCTAGGGA
CGGATGTTGAC -> GGATGTTGACT
CGGATTACTCC -> GGATTACTCCA
CGGCCAAATTC -> GGCCAAATTCG
CGGCCAAGTCG -> GGCCAAGTCGA
CGGCCCACCTG -> GGCCCACCTGC
CGGCCCCGGCG -> GGCCCCGGCGC
CGGCCCCTACT -> GGCCCCTACTA
CGGCCCTTATC -> GGCCCTTATCC
CGGCGCAGTAA -> GGCGCAGTAAA
CGGCGTTCTAA -> GGCGTTCTAAA
CGGCTCTTGTA -> GGCTCTTGTAT
CGGCTTCAACT -> GGCTTCAACTC
CGGGATTCCCT -> GGGATTCCCTT
CGGGTGCACGG -> GGGTGCACGGC
CGGTAACCTGT -> GGTAACCTGTC
CGGTAAGAGGA -> GGTAAGAGGAG
CGGTAATCCTG -> GGTAATCCTGC
CGGTATGTGCA -> GGTATGTGCAG
CGGTCAGACGC -> GGTCAGACGCT
CGGTCGTGAAG -> GGTCGTGAAGT
CGGTCTGCCCA -> GGTCTGCCCAC
CGGTGGTCTGC -> GGTGGTCTGCA
CGGTTCACTGG -> GGTTCACTGGT
CGGTTCAGGGT -> GGTTCAGGGTA
CGGTTGATATA -> GGTTGATATAT
CGGTTTTTTTT -> GGTTTTTTTTG
CGTAAGCGCCT -> GTAAGCGCCTG
CGTAAGTGTGT -> GTAAGTGTGTA
CGTACCTCTTC -> GTACCTCTTCT
CGTAGAGAGTT -> GTAGAGAGTTT
CGTAGGCACGG -> GTAGGCACGGA
CGTAGGTGTAA -> GTAGGTGTAAA
CGTAGTTACCG -> GTAGTTACCGT
CGTATACCCAC -> GTATACCCACA
CGTATAGCCAC -> GTATAGCCACT
CGTATGATGAC -> GTATGATGACA
CGTCCCAGCCA -> GTCCCAGCCAC
CGTCCTATTGT -> GTCCTATTGTG
CGTCGGCCCCT -> GTCGGCCCCTA
CGTCGGCTCTT -> GTCGGCTCTTG
CGTCGTATGAT -> GTCGTATGATG
CGTCTACAGAG -> GTCTACAGAGA
CGTCTGTGCAC -> GTCTGTGCACT
CGTGAAGACAA -> GTGAAGACAAA
CGTGAAGTCAT -> GTGAAGTCATA
CGTGACTCACA -> GTGACTCACAA
CGTGAGACCTT -> GTGAGACCTTC
CGTGAGGACAG -> GTGAGGACAGA
CGTGATGACGT -> GTGATGACGTG
CGTGCAAACCC -> GTGCAAACCCA
CGTGCAAGTGC -> GTGCAAGTGCT
CGTGCCGTCTA -> GTGCCGTCTAC
CGTGGAGTTTA -> GTGGAGTTTAA
CGTGGGCTAAT -> GTGGGCTAATC
CGTGTCATGCA -> GTGTCATGCAT
CGTGTTTACTG -> GTGTTTACTGC
CGTTCTAAAAG -> GTTCTAAAAGG
CGTTGTACCCC -> GTTGTACCCCC
CTAAAAGGAGG -> TAAAAGGAGGC
CTAACATAGCA -> TAACATAGCAC
CTAACGCACTG -> TAACGCACTGA
CTAAGCGTGTT -> TAAGCGTGTTT
CTAAGCTGGGC -> TAAGCTGGGCG
CTAAGGACTCG -> TAAGGACTCGA
CTAAGTTGTAT -> TAAGTTGTATG
CTAATAACAGC -> TAATAACAGCG
CTAATCGCCGA -> TAATCGCCGAA
CTACAAGACTG -> TACAAGACTGC
CTACAGAGAAC -> TACAGAGAACA
CTACAGTGTGC -> TACAGTGTGCC
CTACATCGTGT -> TACATCGTGTC
CTACCAACTCC -> TACCAACTCCA
CTACCTCTCTC -> TACCTCTCTCG
CTACTAAGCTG -> TACTAAGCTGG
CTACTAGAGCG -> TACTAGAGCGT
CTACTCGTACC -> TACTCGTACCT
CTAGAACTTAT -> TAGAACTTATA
CTAGACGATAC -> TAGACGATACT
CTAGAGCGTAA -> TAGAGCGTAAG
CTAGATGTAGC -> TAGATGTAGCA
CTAGCGTGAGG -> TAGCGTGAGGA
CTAGGCACACA -> TAGGCACACAT
CTAGGGAGTAC -> TAGGGAGTACT
CTAGGTTACTG -> TAGGTTACTGT
CTAGGTTTGAT -> TAGGTTTGATT
CTATCACTTGG -> TATCACTTGGT
CTATTGTGTCC -> TATTGTGTCCA
CTCAAACGGGA -> TCAAACGGGAT
CTCACAAGTAA -> TCACAAGTAAT
CTCACATAAGG -> TCACATAAGGA
CTCATTCTCCC -> TCATTCTCCCA
CTCCAACTTAA -> TCCAACTTAAT
CTCCACTCCGT -> TCCACTCCGTA
CTCCATATCCG -> TCCATATCCGC
CTCCCAGATTG -> TCCCAGATTGC
CTCCCGGTCAG -> TCCCGGTCAGA
CTCCGGTTGAT -> TCCGGTTGATA
CTCCGTATAGC -> TCCGTATAGCC
CTCCTAAGTTG -> TCCTAAGTTGT
CTCCTAGATGT -> TCCTAGATGTA
CTCGACTGGAA -> TCGACTGGAAC
CTCGATACACA -> TCGATACACAG
CTCGGCTTCAA -> TCGGCTTCAAC
CTCGGTGGTCT -> TCGGTGGTCTG
CTCGTAAGCGC -> TCGTAAGCGCC
CTCGTACCTCT -> TCGTACCTCTT
CTCTAGGCACA -> TCTAGGCACAC
CTCTCCTAAGT -> TCTCCTAAGTT
CTCTCCTAGAT -> TCTCCTAGATG
CTCTCGACTGG -> TCTCGACTGGA
CTCTCTCGACT -> TCTCTCGACTG
CTCTGGGATAA -> TCTGGGATAAG
CTCTGTGTGGG -> TCTGTGTGGGG
CTCTTCTGACC -> TCTTCTGACCT
CTCTTGTATGT -> TCTTGTATGTA
CTGAACACGAT -> TGAACACGATA
CTGACCGTGCA -> TGACCGTGCAA
CTGACCTTTTC -> TGACCTTTTCA
CTGACGAATTG -> TGACGAATTGT
CTGACTAGAAC -> TGACTAGAACT
CTGAGAACTTA -> TGAGAACTTAA
CTGAGCTCCCG -> TGAGCTCCCGG
CTGATCATCCT -> TGATCATCCTG
CTGATTTTAGG -> TGATTTTAGGC
CTGCACTGACG -> TGCACTGACGA
CTGCAGTGAAC -> TGCAGTGAACG
CTGCAGTGAGT -> TGCAGTGAGTA
CTGCATGGGGT -> TGCATGGGGTG
CTGCCCACAGT -> TGCCCACAGTG
CTGCCCGCATC -> TGCCCGCATCC
CTGCGAGCGGC -> TGCGAGCGGCC
CTGCGATTGGC -> TGCGATTGGCA
CTGCTAACGCA -> TGCTAACGCAC
CTGCTCGTAAG -> TGCTCGTAAGC
CTGCTCTGGGA -> TGCTCTGGGAT
CTGCTCTGTGT -> TGCTCTGTGTG
CTGCTTAGGTT -> TGCTTAGGTTT
CTGGAACTGAG -> TGGAACTGAGA
CTGGAGATAAG -> TGGAGATAAGA
CTGGATTAATC -> TGGATTAATCA
CTGGCCAAGCC -> TGGCCAAGCCA
CTGGCCGATAG -> TGGCCGATAGT
CTGGCGGCCAA -> TGGCGGCCAAA
CTGGGATAAGT -> TGGGATAAGTA
CTGGGCGAGTA -> TGGGCGAGTAA
CTGGGGCCAGG -> TGGGGCCAGGA
CTGGGTATCTA -> TGGGTATCTAC
CTGGTCATGAT -> TGGTCATGATG
CTGGTTGCTAA -> TGGTTGCTAAG
CTGTACGGTCG -> TGTACGGTCGT
CTGTACTTCTT -> TGTACTTCTTC
CTGTAGATATT -> TGTAGATATTG
CTGTCAAGTAC -> TGTCAAGTACT
CTGTCTTCGGA -> TGTCTTCGGAG
CTGTGCACTGA -> TGTGCACTGAC
CTGTGGCGAGC -> TGTGGCGAGCA
CTGTGGGACCG -> TGTGGGACCGA
CTGTGTGGGGC -> TGTGTGGGGCA
CTGTTTCGCAA -> TGTTTCGCAAT
CTTAACTCTAG -> TTAACTCTAGG
CTTAATATTCG -> TTAATATTCGG
CTTAATGGCAA -> TTAATGGCAAT
CTTACGTGGGC -> TTACGTGGGCT
CTTAGAGGATA -> TTAGAGGATAC
CTTAGGTTTAT -> TTAGGTTTATA
CTTATACTCCA -> TTATACTCCAA
CTTATCCAAAC -> TTATCCAAACA
CTTCAACTCTC -> TTCAACTCTCC
CTTCACACTGA -> TTCACACTGAT
CTTCACTGTCA -> TTCACTGTCAA
CTTCCTTCTTT -> TTCCTTCTTTG
CTTCGCAGTCA -> TTCGCAGTCAA
CTTCGGAGCTA -> TTCGGAGCTAG
CTTCGGTAATC -> TTCGGTAATCC
CTTCGTCCTAT -> TTCGTCCTATT
CTTCGTGAGAC -> TTCGTGAGACC
CTTCTAACATA -> TTCTAACATAG
CTTCTAGGTTA -> TTCTAGGTTAC
CTTCTGACCTT -> TTCTGACCTTT
CTTCTTCGTCC -> TTCTTCGTCCT
CTTCTTTGAAG -> TTCTTTGAAGA
CTTGCATACCG -> TTGCATACCGA
CTTGGAGACGG -> TTGGAGACGGT
CTTGGCGCGGT -> TTGGCGCGGTC
CTTGGCTACTC -> TTGGCTACTCG
CTTGGGGATGA -> TTGGGGATGAG
CTTGGTACAAC -> TTGGTACAACT
CTTGTATGTAG -> TTGTATGTAGA
CTTTCTCCGGT -> TTTCTCCGGTT
CTTTGAAGACC -> TTTGAAGACCA
CTTTTCATGAG -> TTTTCATGAGA
GAAAATTGGTC -> AAAATTGGTCC
GAAACCTTGGC -> AAACCTTGGCT
GAAAGGATATC -> AAAGGATATCC
GAAAGGATCAT -> AAAGGATCATT
GAAATACGGTT -> AAATACGGTTC
GAACAAAGTGC -> AACAAAGTGCA
GAACAACTAAG -> AACAACTAAGG
GAACACGATAT -> AACACGATATC
GAACATCCGGT -> AACATCCGGTA
GAACGAGGAAA -> AACGAGGAAAG
GAACTGAGAAC -> AACTGAGAACT
GAACTGCTAAC -> AACTGCTAACG
GAACTTAACTC -> AACTTAACTCT
GAACTTATACT -> AACTTATACTC
GAAGAAACCTT -> AAGAAACCTTG
GAAGACAAAGG -> AAGACAAAGGA
GAAGACCACTA -> AAGACCACTAA
GAAGATATTGT -> AAGATATTGTC
GAAGCATGACT -> AAGCATGACTG
GAAGTCATAGG -> AAGTCATAGGC
GAATAATATAG -> AATAATATAGC
GAATAGGGAAC -> AATAGGGAACT
GAATAGGTTAG -> AATAGGTTAGT
GAATATACGTG -> AATATACGTGA
GAATTCGACAC -> AATTCGACACT
GAATTCTTGGA -> AATTCTTGGAG
GAATTGTAAGG -> AATTGTAAGGT
GACAAAGGAGG -> ACAAAGGAGGG
GACAACTGCAT -> ACAACTGCATG
GACAAGACCTT -> ACAAGACCTTC
GACACTTACGT -> ACACTTACGTG
GACAGACTGTA -> ACAGACTGTAC
GACAGATTGAT -> ACAGATTGATA
GACAGGAATAT -> ACAGGAATATA
GACAGGCTGTG -> ACAGGCTGTGG
GACATGATGAC -> ACATGATGACA
GACATGTCCCC -> ACATGTCCCCA
GACATTACTGC -> ACATTACTGCG
GACCACTAATA -> ACCACTAATAA
GACCGAACAAA -> ACCGAACAAAG
GACCGGAATTC -> ACCGGAATTCT
GACCGTGCAAA -> ACCGTGCAAAC
GACCTGGCCGA -> ACCTGGCCGAT
GACCTTCCTTC -> ACCTTCCTTCT
GACCTTCGCAG -> ACCTTCGCAGT
GACCTTTTCAT -> ACCTTTTCATG
GACGAAGCATG -> ACGAAGCATGA
GACGAATTGTA -> ACGAATTGTAA
GACGATACTTA -> ACGATACTTAG
GACGCTTAATG -> ACGCTTAATGG
GACGGCCAAGT -> ACGGCCAAGTC
GACGGTTTTTT -> ACGGTTTTTTT
GACGTCGGCCC -> ACGTCGGCCCC
GACGTGCCGTC -> ACGTGCCGTCT
GACTAGAACTT -> ACTAGAACTTA
GACTAGGTTTG -> ACTAGGTTTGA
GACTCACAAGT -> ACTCACAAGTA
GACTCGATACA -> ACTCGATACAC
GACTCTCCTAA -> ACTCTCCTAAG
GACTGATTTTA -> ACTGATTTTAG
GACTGCCCGCA -> ACTGCCCGCAT
GACTGGAACTG -> ACTGGAACTGA
GACTGGTCATG -> ACTGGTCATGA
GACTGTACGGT -> ACTGTACGGTC
GACTGTGGGAC -> ACTGTGGGACC
GAGAAAATTGG -> AGAAAATTGGT
GAGAACATCCG -> AGAACATCCGG
GAGAACTTAAC -> AGAACTTAACT
GAGAATAGGGA -> AGAATAGGGAA
GAGACAGGAAT -> AGACAGGAATA
GAGACCGGAAT -> AGACCGGAATT
GAGACCTTCCT -> AGACCTTCCTT
GAGACGGTTTT -> AGACGGTTTTT
GAGACTCTCCT -> AGACTCTCCTA
GAGAGCAGACC -> AGAGCAGACCT
GAGAGTTTGAG -> AGAGTTTGAGA
GAGATAAGATT -> AGATAAGATTA
GAGATAATCAA -> AGATAATCAAC
GAGCAACCACG -> AGCAACCACGC
GAGCAGACCTG -> AGCAGACCTGG
GAGCCGAAGAA -> AGCCGAAGAAA
GAGCGGACAAG -> AGCGGACAAGA
GAGCGGCCCCG -> AGCGGCCCCGG
GAGCGTAAGTG -> AGCGTAAGTGT
GAGCTAGGGAG -> AGCTAGGGAGT
GAGCTCCCGGT -> AGCTCCCGGTC
GAGCTGTACTT -> AGCTGTACTTC
GAGCTTCTAAC -> AGCTTCTAACA
GAGGAAAGGAT -> AGGAAAGGATC
GAGGACAGATT -> AGGACAGATTG
GAGGAGCGGAC -> AGGAGCGGACA
GAGGAGTGACA -> AGGAGTGACAA
GAGGATACGTA -> AGGATACGTAT
GAGGCTGGATT -> AGGCTGGATTA
GAGGGCGGGTG -> AGGGCGGGTGC
GAGGGGCCTAC -> AGGGGCCTACT
GAGGGTATGTT -> AGGGTATGTTG
GAGTAAATTTC -> AGTAAATTTCG
GAGTACATTAC -> AGTACATTACG
GAGTACTTCAC -> AGTACTTCACA
GAGTGACAACT -> AGTGACAACTG
GAGTTCACAGG -> AGTTCACAGGG
GAGTTTAAGCA -> AGTTTAAGCAC
GAGTTTGAGAA -> AGTTTGAGAAT
GATAAGAGCTG -> ATAAGAGCTGT
GATAAGATTAG -> ATAAGATTAGA
GATAAGTAAAC -> ATAAGTAAACA
GATAATCAACG -> ATAATCAACGA
GATACACAGTA -> ATACACAGTAA
GATACGTATAC -> ATACGTATACC
GATACTTAGAG -> ATACTTAGAGG
GATAGTTCCCT -> ATAGTTCCCTA
GATATAGTTGT -> ATATAGTTGTT
GATATATTGAG -> ATATATTGAGG
GATATCCCTGA -> ATATCCCTGAC
GATATCTACCA -> ATATCTACCAA
GATATGAGAGC -> ATATGAGAGCA
GATATGCCGAC -> ATATGCCGACG
GATATTGTCGC -> ATATTGTCGCC
GATATTGTTAG -> ATATTGTTAGC
GATCATCCTGG -> ATCATCCTGGC
GATCATTGGCG -> ATCATTGGCGT
GATCCACCAAT -> ATCCACCAATC
GATCTAGCGTG -> ATCTAGCGTGA
GATGACAGACT -> ATGACAGACTG
GATGACATGAT -> ATGACATGATG
GATGACGTGCC -> ATGACGTGCCG
GATGAGGGCGG -> ATGAGGGCGGG
GATGCGTGAAG -> ATGCGTGAAGA
GATGTAGAACA -> ATGTAGAACAA
GATGTAGCAGA -> ATGTAGCAGAT
GATGTTGACTG -> ATGTTGACTGG
GATTAATCACA -> ATTAATCACAG
GATTACTCCAC -> ATTACTCCACT
GATTAGAGACA -> ATTAGAGACAG
GATTCCCTTCA -> ATTCCCTTCAC
GATTGATATGA -> ATTGATATGAG
GATTGCACGTA -> ATTGCACGTAG
GATTGCCATAG -> ATTGCCATAGT
GATTGGCAAGG -> ATTGGCAAGGA
GATTGTTTGTA -> ATTGTTTGTAC
GATTTTAGGCA -> ATTTTAGGCAT
GCAAACCCAGC -> CAAACCCAGCT
GCAACCACGCC -> CAACCACGCCG
GCAAGGATAAG -> CAAGGATAAGA
GCAAGTGCTCA -> CAAGTGCTCAC,CAAGTGCTCAT
GCAATGAGACT -> CAATGAGACTC
GCAATTTCGAA -> CAATTTCGAAA
GCACACATCCG -> CACACATCCGT
GCACCGGTAAG -> CACCGGTAAGA
GCACGCACTGC -> CACGCACTGCT
GCACGGATTAC -> CACGGATTACT
GCACGGCCCTT -> CACGGCCCTTA
GCACGTAGTTA -> CACGTAGTTAC
GCACTGAACAC -> CACTGAACACG
GCACTGACGAA -> CACTGACGAAT
GCACTGACTAG -> CACTGACTAGA
GCACTGCTCTG -> CACTGCTCTGT
GCACTTCGTGA -> CACTTCGTGAG
GCACTTGCATA -> CACTTGCATAC
GCAGACCTGGC -> CAGACCTGGCC
GCAGACTAGGT -> CAGACTAGGTT
GCAGATCTAGC -> CAGATCTAGCG
GCAGGCCGCAC -> CAGGCCGCACG
GCAGTAAATTA -> CAGTAAATTAA
GCAGTCAATGA -> CAGTCAATGAT
GCAGTGAACGA -> CAGTGAACGAG
GCAGTGAGTAC -> CAGTGAGTACA
GCATACCGAGA -> CATACCGAGAT
GCATCCAAATT -> CATCCAAATTA
GCATGACTGTG -> CATGACTGTGG
GCATGGGGTGT -> CATGGGGTGTT
GCATGTACAGC -> CATGTACAGCG
GCATGTTCTGC -> CATGTTCTGCT
GCATTCATCCT -> CATTCATCCTC
GCCAAAGCTTC -> CCAAAGCTTCT
GCCAAATTCGT -> CCAAATTCGTA
GCCAAGCCAAA -> CCAAGCCAAAG
GCCAAGTCGAA -> CCAAGTCGAAA
GCCACACTGGC -> CCACACTGGCG
GCCACATCTGC -> CCACATCTGCG
GCCACTTGGCG -> CCACTTGGCGC
GCCAGGACTGA -> CCAGGACTGAT
GCCATAGTAGA -> CCATAGTAGAT
GCCCACAGTGA -> CCCACAGTGAG
GCCCACCTGCA -> CCCACCTGCAG
GCCCCGGCGCA -> CCCCGGCGCAG
GCCCCTACTAG -> CCCCTACTAGA
GCCCGCATCCA -> CCCGCATCCAA
GCCCTATCACT -> CCCTATCACTT
GCCCTTATCCA -> CCCTTATCCAA
GCCGAAGAAAC -> CCGAAGAAACC
GCCGAATAATA -> CCGAATAATAT
GCCGACGGCCA -> CCGACGGCCAA
GCCGATAGTTC -> CCGATAGTTCC
GCCGCACGCAC -> CCGCACGCACT
GCCGCCGGCGT -> CCGCCGGCGTT
GCCGGCGTTCT -> CCGGCGTTCTA
GCCGTCCCAGC -> CCGTCCCAGCC
GCCGTCGTATG -> CCGTCGTATGA
GCCGTCTACAG -> CCGTCTACAGA
GCCTACTAAGC -> CCTACTAAGCT
GCCTGAGCTCC -> CCTGAGCTCCC
GCGAGCAACCA -> CGAGCAACCAC
GCGAGCGGCCC -> CGAGCGGCCCC
GCGAGTAAATT -> CGAGTAAATTT
GCGATATAGTT -> CGATATAGTTG
GCGATTGGCAA -> CGATTGGCAAG
GCGCAAGTGCT -> CGCAAGTGCTC
GCGCAGTAAAT -> CGCAGTAAATT
GCGCCTGAGCT -> CGCCTGAGCTC
GCGCGGTCTGC -> CGCGGTCTGCC
GCGGACAAGAC -> CGGACAAGACC
GCGGCCAAATT -> CGGCCAAATTC
GCGGCCCACCT -> CGGCCCACCTG
GCGGCCCCGGC -> CGGCCCCGGCG
GCGGGTGCACG -> CGGGTGCACGG
GCGGTCTGCCC -> CGGTCTGCCCA
GCGTAAGTGTG -> CGTAAGTGTGT
GCGTAGGCACG -> CGTAGGCACGG
GCGTAGGTGTA -> CGTAGGTGTAA
GCGTGAAGACA -> CGTGAAGACAA
GCGTGAGGACA -> CGTGAGGACAG
GCGTGTTTACT -> CGTGTTTACTG
GCGTTCTAAAA -> CGTTCTAAAAG
GCTAACGCACT -> CTAACGCACTG
GCTAAGCGTGT -> CTAAGCGTGTT
GCTAATCGCCG -> CTAATCGCCGA
GCTACAAGACT -> CTACAAGACTG
GCTACTCGTAC -> CTACTCGTACC
GCTAGACGATA -> CTAGACGATAC
GCTAGGGAGTA -> CTAGGGAGTAC
GCTCACATAAG -> CTCACATAAGG
GCTCATTCTCC -> CTCATTCTCCC
GCTCCCGGTCA -> CTCCCGGTCAG
GCTCGTAAGCG -> CTCGTAAGCGC
GCTCTGGGATA -> CTCTGGGATAA
GCTCTGTGTGG -> CTCTGTGTGGG
GCTCTTGTATG -> CTCTTGTATGT
GCTGCTTAGGT -> CTGCTTAGGTT
GCTGGAGATAA -> CTGGAGATAAG
GCTGGATTAAT -> CTGGATTAATC
GCTGGGCGAGT -> CTGGGCGAGTA
GCTGGGGCCAG -> CTGGGGCCAGG
GCTGTACTTCT -> CTGTACTTCTT
GCTGTGGCGAG -> CTGTGGCGAGC
GCTGTTTCGCA -> CTGTTTCGCAA
GCTTAATGGCA -> CTTAATGGCAA
GCTTAGGTTTA -> CTTAGGTTTAT
GCTTCAACTCT -> CTTCAACTCTC
GCTTCGGTAAT -> CTTCGGTAATC
GCTTCTAACAT -> CTTCTAACATA
GCTTCTAGGTT -> CTTCTAGGTTA
GGAAAGGATCA -> GAAAGGATCAT
GGAACTGAGAA -> GAACTGAGAAC
GGAACTGCTAA -> GAACTGCTAAC
GGAATATACGT -> GAATATACGTG
GGAATTCTTGG -> GAATTCTTGGA
GGACAAGACCT -> GACAAGACCTT
GGACAGATTGA -> GACAGATTGAT
GGACAGGCTGT -> GACAGGCTGTG
GGACATGTCCC -> GACATGTCCCC
GGACCGAACAA -> GACCGAACAAA
GGACGAAGCAT -> GACGAAGCATG
GGACTCGATAC -> GACTCGATACA
GGACTGATTTT -> GACTGATTTTA
GGAGACCGGAA -> GAGACCGGAAT
GGAGACGGTTT -> GAGACGGTTTT
GGAGATAAGAT -> GAGATAAGATT
GGAGCGGACAA -> GAGCGGACAAG
GGAGCTAGGGA -> GAGCTAGGGAG
GGAGGCTGGAT -> GAGGCTGGATT
GGAGGGTATGT -> GAGGGTATGTT
GGAGTACTTCA -> GAGTACTTCAC
GGAGTGACAAC -> GAGTGACAACT
GGAGTTTAAGC -> GAGTTTAAGCA
GGATAAGAGCT -> GATAAGAGCTG
GGATAAGTAAA -> GATAAGTAAAC
GGATACGTATA -> GATACGTATAC
GGATATCCCTG -> GATATCCCTGA
GGATCATTGGC -> GATCATTGGCG
GGATGAGGGCG -> GATGAGGGCGG
GGATGTTGACT -> GATGTTGACTG
GGATTAATCAC -> GATTAATCACA
GGATTACTCCA -> GATTACTCCAC
GGATTCCCTTC -> GATTCCCTTCA
GGCAAGGATAA -> GCAAGGATAAG
GGCAATTTCGA -> GCAATTTCGAA
GGCACACATCC -> GCACACATCCG
GGCACGGATTA -> GCACGGATTAC
GGCACTTGCAT -> GCACTTGCATA
GGCAGACTAGG -> GCAGACTAGGT
GGCATGTTCTG -> GCATGTTCTGC
GGCCAAATTCG -> GCCAAATTCGT
GGCCAAGCCAA -> GCCAAGCCAAA
GGCCAAGTCGA -> GCCAAGTCGAA
GGCCAGGACTG -> GCCAGGACTGA
GGCCCACCTGC -> GCCCACCTGCA
GGCCCCGGCGC -> GCCCCGGCGCA
GGCCCCTACTA -> GCCCCTACTAG
GGCCCTTATCC -> GCCCTTATCCA
GGCCGATAGTT -> GCCGATAGTTC
GGCCGCACGCA -> GCCGCACGCAC
GGCCTACTAAG -> GCCTACTAAGC
GGCGAGCAACC -> GCGAGCAACCA
GGCGAGTAAAT -> GCGAGTAAATT
GGCGCAGTAAA -> GCGCAGTAAAT
GGCGCGGTCTG -> GCGCGGTCTGC
GGCGGCCAAAT -> GCGGCCAAATT
GGCGGGTGCAC -> GCGGGTGCACG
GGCGTAGGCAC -> GCGTAGGCACG
GGCGTTCTAAA -> GCGTTCTAAAA
GGCTAATCGCC -> GCTAATCGCCG
GGCTACTCGTA -> GCTACTCGTAC
GGCTCTTGTAT -> GCTCTTGTATG
GGCTGCTTAGG -> GCTGCTTAGGT
GGCTGGAGATA -> GCTGGAGATAA
GGCTGGATTAA -> GCTGGATTAAT
GGCTGTGGCGA -> GCTGTGGCGAG
GGCTTCAACTC -> GCTTCAACTCT
GGGAACTGCTA -> GGAACTGCTAA
GGGACCGAACA -> GGACCGAACAA
GGGAGTACTTC -> GGAGTACTTCA
GGGATAAGTAA -> GGATAAGTAAA
GGGATGAGGGC -> GGATGAGGGCG
GGGATTCCCTT -> GGATTCCCTTC
GGGCACTTGCA -> GGCACTTGCAT
GGGCAGACTAG -> GGCAGACTAGG
GGGCCAGGACT -> GGCCAGGACTG
GGGCCTACTAA -> GGCCTACTAAG
GGGCGAGTAAA -> GGCGAGTAAAT
GGGCGGGTGCA -> GGCGGGTGCAC
GGGCTAATCGC -> GGCTAATCGCC
GGGGATGAGGG -> GGGATGAGGGC
GGGGCACTTGC -> GGGCACTTGCA
GGGGCCAGGAC -> GGGCCAGGACT
GGGGCCTACTA -> GGGCCTACTAA
GGGTACATGAT -> GGTACATGATT
GGGTATCTACC -> GGTATCTACCT
GGGTATGTTGA -> GGTATGTTGAC
GGGTGCACGGC -> GGTGCACGGCC
GGTAACCTGTC -> GTAACCTGTCT
GGTAAGAGGAG -> GTAAGAGGAGC
GGTAATCCTGC -> GTAATCCTGCA
GGTACAACTCG -> GTACAACTCGG
GGTACATGATT -> GTACATGATTG
GGTATCTACCT -> GTATCTACCTC
GGTATGTGCAG -> GTATGTGCAGG
GGTATGTTGAC -> GTATGTTGACA
GGTCAGACGCT -> GTCAGACGCTT
GGTCATGATGC -> GTCATGATGCG
GGTCCACTCAA -> GTCCACTCAAA
GGTCGTGAAGT -> GTCGTGAAGTC
GGTCTGCAGTG -> GTCTGCAGTGA
GGTCTGCCCAC -> GTCTGCCCACA
GGTGCACGGCC -> GTGCACGGCCC
GGTGGTCTGCA -> GTGGTCTGCAG
GGTGTAAAACG -> GTGTAAAACGC
GGTTACTGTAG -> GTTACTGTAGA
GGTTAGTAGGA -> GTTAGTAGGAC
GGTTCAATGCT -> GTTCAATGCTG
GGTTCACTGGT -> GTTCACTGGTT
GGTTCAGGGTA -> GTTCAGGGTAC
GGTTGATATAT -> GTTGATATATT
GGTTGCTAAGC -> GTTGCTAAGCG
GGTTTATATCG -> GTTTATATCGA
GGTTTGATTGT -> GTTTGATTGTT
GGTTTTTTTTG -> GTTTTTTTTGT
GTAAAACGCTA -> TAAAACGCTAC
GTAAACAGTAA -> TAAACAGTAAT
GTAAAGAAGAT -> TAAAGAAGATA
GTAAATTAAGC -> TAAATTAAGCG
GTAAATTTCGG -> TAAATTTCGGT
GTAACCTGTCT -> TAACCTGTCTT
GTAAGAGGAGC -> TAAGAGGAGCG
GTAAGCGCCTG -> TAAGCGCCTGA
GTAAGGTTCAA -> TAAGGTTCAAT
GTAAGTGTGTA -> TAAGTGTGTAC
GTAATCCTGCA -> TAATCCTGCAC
GTAATCGATGT -> TAATCGATGTA
GTAATTCACGT -> TAATTCACGTT
GTACAACTCGG -> TACAACTCGGC
GTACAGCGTAG -> TACAGCGTAGG
GTACATGATTG -> TACATGATTGC
GTACATTACGT -> TACATTACGTG
GTACCCCCGGT -> TACCCCCGGTT
GTACCTCTTCT -> TACCTCTTCTG
GTACGGATGTT -> TACGGATGTTG
GTACGGTCGTG -> TACGGTCGTGA
GTACGTCTGTG -> TACGTCTGTGC
GTACTACAGTG -> TACTACAGTGT
GTACTTCACAC -> TACTTCACACT
GTACTTCTTCG -> TACTTCTTCGT
GTAGAACAACT -> TAGAACAACTA
GTAGAATTCGA -> TAGAATTCGAC
GTAGAGAGTTT -> TAGAGAGTTTG
GTAGATATGCC -> TAGATATGCCG
GTAGATATTGT -> TAGATATTGTT
GTAGCAGATCT -> TAGCAGATCTA
GTAGGACATGT -> TAGGACATGTC
GTAGGCACGGA -> TAGGCACGGAT
GTAGGTGTAAA -> TAGGTGTAAAA
GTAGTTACCGT -> TAGTTACCGTG
GTATACCCACA -> TATACCCACAG
GTATAGCCACT -> TATAGCCACTT
GTATCTACCTC -> TATCTACCTCT
GTATGAGCCGA -> TATGAGCCGAA
GTATGATGACA -> TATGATGACAT
GTATGGCTGCT -> TATGGCTGCTT
GTATGTAGAAT -> TATGTAGAATT
GTATGTGCAGG -> TATGTGCAGGC
GTATGTTGACA -> TATGTTGACAT
GTCAAGTACTA -> TCAAGTACTAC
GTCAATGATCC -> TCAATGATCCA
GTCAGACGCTT -> TCAGACGCTTA
GTCATAGGCTG -> TCATAGGCTGG
GTCATGATGCG -> TCATGATGCGT
GTCATGCATTC -> TCATGCATTCA
GTCCACTCAAA -> TCCACTCAAAC
GTCCACTTGGG -> TCCACTTGGGG
GTCCCAGCCAC -> TCCCAGCCACA
GTCCCCAATAG -> TCCCCAATAGT
GTCCTATTGTG -> TCCTATTGTGT
GTCGAAATACG -> TCGAAATACGG
GTCGCCACACT -> TCGCCACACTG
GTCGGCCCCTA -> TCGGCCCCTAC
GTCGGCTCTTG -> TCGGCTCTTGT
GTCGTATGATG -> TCGTATGATGA
GTCGTGAAGTC -> TCGTGAAGTCA
GTCTACAGAGA -> TCTACAGAGAA
GTCTGCAGTGA -> TCTGCAGTGAA
GTCTGCCCACA -> TCTGCCCACAG
GTCTGTGCACT -> TCTGTGCACTG
GTCTTCGGAGC -> TCTTCGGAGCT
GTCTTTCTCCG -> TCTTTCTCCGG
GTGAACGAGGA -> TGAACGAGGAA
GTGAAGACAAA -> TGAAGACAAAG
GTGAAGTCATA -> TGAAGTCATAG
GTGAATAGGTT -> TGAATAGGTTA
GTGACAACTGC -> TGACAACTGCA
GTGACTCACAA -> TGACTCACAAG
GTGAGACCTTC -> TGAGACCTTCC
GTGAGCTTCTA -> TGAGCTTCTAA
GTGAGGACAGA -> TGAGGACAGAT
GTGAGTACATT -> TGAGTACATTA
GTGATGACGTG -> TGATGACGTGC
GTGCAAACCCA -> TGCAAACCCAG
GTGCAAGTGCT -> TGCAAGTGCTC
GTGCACGGCCC -> TGCACGGCCCT
GTGCACTGACT -> TGCACTGACTA
GTGCAGGCCGC -> TGCAGGCCGCA
GTGCATGTACA -> TGCATGTACAG
GTGCCGTCCCA -> TGCCGTCCCAG
GTGCCGTCGTA -> TGCCGTCGTAT
GTGCCGTCTAC -> TGCCGTCTACA
GTGCTCACATA -> TGCTCACATAA
GTGCTCATTCT -> TGCTCATTCTC
GTGGAGTTTAA -> TGGAGTTTAAG
GTGGCGAGCAA -> TGGCGAGCAAC
GTGGGACCGAA -> TGGGACCGAAC
GTGGGCTAATC -> TGGGCTAATCG
GTGGGGCACTT -> TGGGGCACTTG
GTGGTCTGCAG -> TGGTCTGCAGT
GTGTAAAACGC -> TGTAAAACGCT
GTGTACGTCTG -> TGTACGTCTGT
GTGTATGGCTG -> TGTATGGCTGC
GTGTCATGCAT -> TGTCATGCATT
GTGTCCACTTG -> TGTCCACTTGG
GTGTGCCGTCC -> TGTGCCGTCCC
GTGTGGGGCAC -> TGTGGGGCACT
GTGTGTACGTC -> TGTGTACGTCT
GTGTTTACTGC -> TGTTTACTGCT
GTTACCGTGAC -> TTACCGTGACT
GTTACTGTAGA -> TTACTGTAGAT
GTTAGCTGTTT -> TTAGCTGTTTC
GTTAGTAGGAC -> TTAGTAGGACA
GTTCAATGCTG -> TTCAATGCTGG
GTTCACAGGGC -> TTCACAGGGCA
GTTCACTGGTT -> TTCACTGGTTG
GTTCAGGGTAC -> TTCAGGGTACA
GTTCCCTACAT -> TTCCCTACATC
GTTCTAAAAGG -> TTCTAAAAGGA
GTTCTGCTCGT -> TTCTGCTCGTA
GTTGACATTAC -> TTGACATTACT
GTTGACTGGTC -> TTGACTGGTCA
GTTGATATATT -> TTGATATATTG
GTTGCTAAGCG -> TTGCTAAGCGT
GTTGTACCCCC -> TTGTACCCCCG
GTTGTATGAGC -> TTGTATGAGCC
GTTGTTTAGCC -> TTGTTTAGCCC
GTTTAAGCACC -> TTTAAGCACCG
GTTTACTGCTC -> TTTACTGCTCT
GTTTAGCCCTA -> TTTAGCCCTAT
GTTTATATCGA -> TTTATATCGAC
GTTTCGCAATG -> TTTCGCAATGA
GTTTGAGAATA -> TTTGAGAATAG
GTTTGATTGTT -> TTTGATTGTTT
GTTTGTACGGA -> TTTGTACGGAT
GTTTTTTTTGT -> TTTTTTTTGTG
TAAAACGCTAC -> AAAACGCTACA
TAAAAGGAGGC -> AAAAGGAGGCT
TAAACAGTAAT -> AAACAGTAATT
TAAAGAAGATA -> AAAGAAGATAT
TAAATTAAGCG -> AAATTAAGCGA
TAAATTTCGGT -> AAATTTCGGTA
TAACAGCGCAA -> AACAGCGCAAG
TAACATAGCAC -> AACATAGCACT
TAACCTGTCTT -> AACCTGTCTTC
TAACGCACTGA -> AACGCACTGAA
TAACTCTAGGC -> AACTCTAGGCA
TAAGAGCTGTA -> AAGAGCTGTAC
TAAGAGGAGCG -> AAGAGGAGCGG
TAAGATTAGAG -> AAGATTAGAGA
TAAGCACCGGT -> AAGCACCGGTA
TAAGCGATATA -> AAGCGATATAG
TAAGCGCCTGA -> AAGCGCCTGAG
TAAGCGTGTTT -> AAGCGTGTTTA
TAAGCTGGGCG -> AAGCTGGGCGA
TAAGGACTCGA -> AAGGACTCGAT
TAAGGAGACCG -> AAGGAGACCGG
TAAGGTTCAAT -> AAGGTTCAATG
TAAGTAAACAG -> AAGTAAACAGT
TAAGTGTGTAC -> AAGTGTGTACG
TAAGTTGTATG -> AAGTTGTATGA
TAATAACAGCG -> AATAACAGCGC
TAATATAGCTT -> AATATAGCTTC
TAATATTCGGA -> AATATTCGGAC
TAATCAACGAG -> AATCAACGAGG
TAATCACAGGA -> AATCACAGGAC
TAATCCTGCAC -> AATCCTGCACT
TAATCGATGTA -> AATCGATGTAG
TAATCGCCGAA -> AATCGCCGAAT
TAATGGCAATT -> AATGGCAATTT
TAATTCACGTT -> AATTCACGTTG
TAATTTCTGGG -> AATTTCTGGGT
TACAACTCGGC -> ACAACTCGGCT
TACAAGACTGC -> ACAAGACTGCC
TACACAGTAAA -> ACACAGTAAAG
TACAGAGAACA -> ACAGAGAACAT
TACAGCGTAGG -> ACAGCGTAGGT
TACAGTGTGCC -> ACAGTGTGCCG
TACATCGTGTC -> ACATCGTGTCA
TACATGATTGC -> ACATGATTGCA
TACATTACGTG -> ACATTACGTGG
TACCAACTCCA -> ACCAACTCCAT
TACCCACAGTG -> ACCCACAGTGT
TACCCCCGGTT -> ACCCCCGGTTC
TACCGAGATAA -> ACCGAGATAAT
TACCGTGACTC -> ACCGTGACTCA
TACCTCTCTCG -> ACCTCTCTCGA
TACCTCTTCTG -> ACCTCTTCTGA
TACGGATGTTG -> ACGGATGTTGA
TACGGTCGTGA -> ACGGTCGTGAA
TACGGTTCACT -> ACGGTTCACTG
TACGTATACCC -> ACGTATACCCA
TACGTCTGTGC -> ACGTCTGTGCA
TACGTGATGAC -> ACGTGATGACG
TACGTGGAGTT -> ACGTGGAGTTT
TACGTGGGCTA -> ACGTGGGCTAA
TACTAAGCTGG -> ACTAAGCTGGG
TACTACAGTGT -> ACTACAGTGTG
TACTAGAGCGT -> ACTAGAGCGTA
TACTCCAACTT -> ACTCCAACTTA
TACTCCACTCC -> ACTCCACTCCG
TACTCGTACCT -> ACTCGTACCTC
TACTGCGAGCG -> ACTGCGAGCGG
TACTGCTCTGG -> ACTGCTCTGGG
TACTGTAGATA -> ACTGTAGATAT
TACTTAGAGGA -> ACTTAGAGGAT
TACTTCACACT -> ACTTCACACTG
TACTTCTTCGT -> ACTTCTTCGTC
TAGAACAACTA -> AGAACAACTAA
TAGAACTTATA -> AGAACTTATAC
TAGAATTCGAC -> AGAATTCGACA
TAGACGATACT -> AGACGATACTT
TAGAGACAGGA -> AGAGACAGGAA
TAGAGAGTTTG -> AGAGAGTTTGA
TAGAGCGTAAG -> AGAGCGTAAGT
TAGAGGATACG -> AGAGGATACGT
TAGAGTTCACA -> AGAGTTCACAG
TAGATATGCCG -> AGATATGCCGA
TAGATATTGTT -> AGATATTGTTA
TAGATGTAGCA -> AGATGTAGCAG
TAGCACTTCGT -> AGCACTTCGTG
TAGCAGATCTA -> AGCAGATCTAG
TAGCCACTTGG -> AGCCACTTGGC
TAGCCCTATCA -> AGCCCTATCAC
TAGCGTGAGGA -> AGCGTGAGGAC
TAGCTGTTTCG -> AGCTGTTTCGC
TAGCTTCGGTA -> AGCTTCGGTAA
TAGGACATGTC -> AGGACATGTCC
TAGGCACACAT -> AGGCACACATC
TAGGCACGGAT -> AGGCACGGATT
TAGGCATGTTC -> AGGCATGTTCT
TAGGCTGGAGA -> AGGCTGGAGAT
TAGGGAACTGC -> AGGGAACTGCT
TAGGGAGTACT -> AGGGAGTACTT
TAGGTGTAAAA -> AGGTGTAAAAC
TAGGTTACTGT -> AGGTTACTGTA
TAGGTTAGTAG -> AGGTTAGTAGG
TAGGTTTATAT -> AGGTTTATATC
TAGGTTTGATT -> AGGTTTGATTG
TAGTAGATATG -> AGTAGATATGC
TAGTAGGACAT -> AGTAGGACATG
TAGTCTTTCTC -> AGTCTTTCTCC
TAGTTACCGTG -> AGTTACCGTGA
TAGTTCCCTAC -> AGTTCCCTACA
TAGTTGTTTAG -> AGTTGTTTAGC
TATACCCACAG -> ATACCCACAGT
TATACGTGATG -> ATACGTGATGA
TATACTCCAAC -> ATACTCCAACT
TATAGCCACTT -> ATAGCCACTTG
TATAGCTTCGG -> ATAGCTTCGGT
TATAGTTGTTT -> ATAGTTGTTTA
TATATCGACGT -> ATATCGACGTC
TATATTGAGGG -> ATATTGAGGGG
TATCACTTGGT -> ATCACTTGGTA
TATCCAAACAT -> ATCCAAACATT
TATCCCTGACC -> ATCCCTGACCG
TATCCGCGGCC -> ATCCGCGGCCC
TATCGACGTCG -> ATCGACGTCGG
TATCTACCAAC -> ATCTACCAACT
TATCTACCTCT -> ATCTACCTCTC
TATGAGAGCAG -> ATGAGAGCAGA
TATGAGCCGAA -> ATGAGCCGAAG
TATGATGACAT -> ATGATGACATG
TATGCCGACGG -> ATGCCGACGGC
TATGGCTGCTT -> ATGGCTGCTTA
TATGTAGAATT -> ATGTAGAATTC
TATGTGCAGGC -> ATGTGCAGGCC
TATGTTGACAT -> ATGTTGACATT
TATTCGGACAG -> ATTCGGACAGG
TATTGAGGGGC -> ATTGAGGGGCC
TATTGTCGCCA -> ATTGTCGCCAC
TATTGTGTCCA -> ATTGTGTCCAC
TATTGTTAGCT -> ATTGTTAGCTG
TATTTAATTTC -> ATTTAATTTCT
TCAAACGGGAT -> CAAACGGGATT
TCAACGAGGAG -> CAACGAGGAGT
TCAACTCTCCT -> CAACTCTCCTA
TCAAGTACTAC -> CAAGTACTACA
TCAATGATCCA -> CAATGATCCAC
TCAATGCTGGG -> CAATGCTGGGG
TCACAAGTAAT -> CACAAGTAATC
TCACACTGATC -> CACACTGATCA
TCACAGGACGA -> CACAGGACGAA
TCACAGGGCAG -> CACAGGGCAGA
TCACATAAGGA -> CACATAAGGAG
TCACGTTGTAC -> CACGTTGTACC
TCACTGGTTGC -> CACTGGTTGCT
TCACTGTCAAG -> CACTGTCAAGT
TCACTTGGTAC -> CACTTGGTACA
TCAGACGCTTA -> CAGACGCTTAA
TCAGGGTACAT -> CAGGGTACATG
TCATAGGCTGG -> CATAGGCTGGA
TCATCCTCGGT -> CATCCTCGGTG
TCATCCTGGCC -> CATCCTGGCCA
TCATGAGAAAA -> CATGAGAAAAT
TCATGATGCGT -> CATGATGCGTG
TCATGCATTCA -> CATGCATTCAT
TCATTCTCCCA -> CATTCTCCCAG
TCATTGGCGTA -> CATTGGCGTAG
TCCAAACATTA -> CCAAACATTAT
TCCAAATTAGA -> CCAAATTAGAG
TCCAACTTAAT -> CCAACTTAATA
TCCACCAATCG -> CCACCAATCGT
TCCACTCAAAC -> CCACTCAAACG
TCCACTCCGTA -> CCACTCCGTAT
TCCACTTGGGG -> CCACTTGGGGA
TCCATATCCGC -> CCATATCCGCG
TCCCAGATTGC -> CCCAGATTGCC
TCCCAGCCACA -> CCCAGCCACAT
TCCCCAATAGT -> CCCCAATAGTC
TCCCGGTCAGA -> CCCGGTCAGAC
TCCCTACATCG -> CCCTACATCGT
TCCCTGACCGT -> CCCTGACCGTG
TCCCTTCACTG -> CCCTTCACTGT
TCCGCGGCCCA -> CCGCGGCCCAC
TCCGGTATGTG -> CCGGTATGTGC
TCCGGTTGATA -> CCGGTTGATAT
TCCGTATAGCC -> CCGTATAGCCA
TCCGTCGGCTC -> CCGTCGGCTCT
TCCTAAGTTGT -> CCTAAGTTGTA
TCCTAGATGTA -> CCTAGATGTAG
TCCTATTGTGT -> CCTATTGTGTC
TCCTCGGTGGT -> CCTCGGTGGTC
TCCTGCACTGA -> CCTGCACTGAC
TCCTGGCCAAG -> CCTGGCCAAGC
TCCTTCTTTGA -> CCTTCTTTGAA
TCGAAAGGATA -> CGAAAGGATAT
TCGAAATACGG -> CGAAATACGGT
TCGACACTTAC -> CGACACTTACG
TCGACGTCGGC -> CGACGTCGGCC
TCGACTGGAAC -> CGACTGGAACT
TCGATACACAG -> CGATACACAGT
TCGATGTAGAA -> CGATGTAGAAC
TCGCAATGAGA -> CGCAATGAGAC
TCGCAGTCAAT -> CGCAGTCAATG
TCGCCACACTG -> CGCCACACTGG
TCGCCGAATAA -> CGCCGAATAAT
TCGGACAGGCT -> CGGACAGGCTG
TCGGAGCTAGG -> CGGAGCTAGGG
TCGGCCCCTAC -> CGGCCCCTACT
TCGGCTCTTGT -> CGGCTCTTGTA
TCGGCTTCAAC -> CGGCTTCAACT
TCGGTAACCTG -> CGGTAACCTGT
TCGGTAATCCT -> CGGTAATCCTG
TCGGTGGTCTG -> CGGTGGTCTGC
TCGTAAGCGCC -> CGTAAGCGCCT
TCGTACCTCTT -> CGTACCTCTTC
TCGTAGAGAGT -> CGTAGAGAGTT
TCGTATGATGA -> CGTATGATGAC
TCGTCCTATTG -> CGTCCTATTGT
TCGTGAAGTCA -> CGTGAAGTCAT
TCGTGAGACCT -> CGTGAGACCTT
TCGTGCAAGTG -> CGTGCAAGTGC
TCGTGTCATGC -> CGTGTCATGCA
TCTAAAAGGAG -> CTAAAAGGAGG
TCTAACATAGC -> CTAACATAGCA
TCTACAGAGAA -> CTACAGAGAAC
TCTACCAACTC -> CTACCAACTCC
TCTACCTCTCT -> CTACCTCTCTC
TCTAGCGTGAG -> CTAGCGTGAGG
TCTAGGCACAC -> CTAGGCACACA
TCTAGGTTACT -> CTAGGTTACTG
TCTCCCAGATT -> CTCCCAGATTG
TCTCCGGTTGA -> CTCCGGTTGAT
TCTCCTAAGTT -> CTCCTAAGTTG
TCTCCTAGATG -> CTCCTAGATGT
TCTCGACTGGA -> CTCGACTGGAA
TCTCTCGACTG -> CTCTCGACTGG
TCTGACCTTTT -> CTGACCTTTTC
TCTGCAGTGAA -> CTGCAGTGAAC
TCTGCCCACAG -> CTGCCCACAGT
TCTGCGATTGG -> CTGCGATTGGC
TCTGCTCGTAA -> CTGCTCGTAAG
TCTGGGATAAG -> CTGGGATAAGT
TCTGGGTATCT -> CTGGGTATCTA
TCTGTGCACTG -> CTGTGCACTGA
TCTGTGTGGGG -> CTGTGTGGGGC
TCTTCGGAGCT -> CTTCGGAGCTA
TCTTCGTCCTA -> CTTCGTCCTAT
TCTTCTGACCT -> CTTCTGACCTT
TCTTGGAGACG -> CTTGGAGACGG
TCTTGTATGTA -> CTTGTATGTAG
TCTTTCTCCGG -> CTTTCTCCGGT
TCTTTGAAGAC -> CTTTGAAGACC
TGAACACGATA -> GAACACGATAT
TGAACGAGGAA -> GAACGAGGAAA
TGAAGACAAAG -> GAAGACAAAGG
TGAAGACCACT -> GAAGACCACTA
TGAAGTCATAG -> GAAGTCATAGG
TGAATAGGTTA -> GAATAGGTTAG
TGACAACTGCA -> GACAACTGCAT
TGACAGACTGT -> GACAGACTGTA
TGACATGATGA -> GACATGATGAC
TGACATTACTG -> GACATTACTGC
TGACCGTGCAA -> GACCGTGCAAA
TGACCTTTTCA -> GACCTTTTCAT
TGACGAATTGT -> GACGAATTGTA
TGACGTGCCGT -> GACGTGCCGTC
TGACTAGAACT -> GACTAGAACTT
TGACTCACAAG -> GACTCACAAGT
TGACTGGTCAT -> GACTGGTCATG
TGACTGTGGGA -> GACTGTGGGAC
TGAGAAAATTG -> GAGAAAATTGG
TGAGAACTTAA -> GAGAACTTAAC
TGAGAATAGGG -> GAGAATAGGGA
TGAGACCTTCC -> GAGACCTTCCT
TGAGACTCTCC -> GAGACTCTCCT
TGAGAGCAGAC -> GAGAGCAGACC
TGAGCCGAAGA -> GAGCCGAAGAA
TGAGCTCCCGG -> GAGCTCCCGGT
TGAGCTTCTAA -> GAGCTTCTAAC
TGAGGACAGAT -> GAGGACAGATT
TGAGGGCGGGT -> GAGGGCGGGTG
TGAGGGGCCTA -> GAGGGGCCTAC
TGAGTACATTA -> GAGTACATTAC
TGATATATTGA -> GATATATTGAG
TGATATGAGAG -> GATATGAGAGC
TGATCATCCTG -> GATCATCCTGG
TGATCCACCAA -> GATCCACCAAT
TGATGACAGAC -> GATGACAGACT
TGATGACATGA -> GATGACATGAT
TGATGACGTGC -> GATGACGTGCC
TGATGCGTGAA -> GATGCGTGAAG
TGATTGCACGT -> GATTGCACGTA
TGATTGTTTGT -> GATTGTTTGTA
TGATTTTAGGC -> GATTTTAGGCA
TGCAAACCCAG -> GCAAACCCAGC
TGCAAGTGCTC -> GCAAGTGCTCA
TGCACGGCCCT -> GCACGGCCCTT
TGCACGTAGTT -> GCACGTAGTTA
TGCACTGACGA -> GCACTGACGAA
TGCACTGACTA -> GCACTGACTAG
TGCAGGCCGCA -> GCAGGCCGCAC
TGCAGTGAACG -> GCAGTGAACGA
TGCAGTGAGTA -> GCAGTGAGTAC
TGCATACCGAG -> GCATACCGAGA
TGCATGGGGTG -> GCATGGGGTGT
TGCATGTACAG -> GCATGTACAGC
TGCATTCATCC -> GCATTCATCCT
TGCCATAGTAG -> GCCATAGTAGA
TGCCCACAGTG -> GCCCACAGTGA
TGCCCGCATCC -> GCCCGCATCCA
TGCCGACGGCC -> GCCGACGGCCA
TGCCGTCCCAG -> GCCGTCCCAGC
TGCCGTCGTAT -> GCCGTCGTATG
TGCCGTCTACA -> GCCGTCTACAG
TGCGAGCGGCC -> GCGAGCGGCCC
TGCGATTGGCA -> GCGATTGGCAA
TGCGTGAAGAC -> GCGTGAAGACA
TGCTAACGCAC -> GCTAACGCACT
TGCTAAGCGTG -> GCTAAGCGTGT
TGCTCACATAA -> GCTCACATAAG
TGCTCATTCTC -> GCTCATTCTCC
TGCTCGTAAGC -> GCTCGTAAGCG
TGCTCTGGGAT -> GCTCTGGGATA
TGCTCTGTGTG -> GCTCTGTGTGG
TGCTGGGGCCA -> GCTGGGGCCAG
TGCTTAGGTTT -> GCTTAGGTTTA
TGGAACTGAGA -> GGAACTGAGAA
TGGAGACGGTT -> GGAGACGGTTT
TGGAGATAAGA -> GGAGATAAGAT
TGGAGTTTAAG -> GGAGTTTAAGC
TGGATTAATCA -> GGATTAATCAC
TGGCAAGGATA -> GGCAAGGATAA
TGGCAATTTCG -> GGCAATTTCGA
TGGCCAAGCCA -> GGCCAAGCCAA
TGGCCGATAGT -> GGCCGATAGTT
TGGCGAGCAAC -> GGCGAGCAACC
TGGCGCGGTCT -> GGCGCGGTCTG
TGGCGGCCAAA -> GGCGGCCAAAT
TGGCGTAGGCA -> GGCGTAGGCAC
TGGCTACTCGT -> GGCTACTCGTA
TGGCTGCTTAG -> GGCTGCTTAGG
TGGGACCGAAC -> GGGACCGAACA
TGGGATAAGTA -> GGGATAAGTAA
TGGGCGAGTAA -> GGGCGAGTAAA
TGGGCTAATCG -> GGGCTAATCGC
TGGGGATGAGG -> GGGGATGAGGG
TGGGGCACTTG -> GGGGCACTTGC
TGGGGCCAGGA -> GGGGCCAGGAC
TGGGTATCTAC -> GGGTATCTACC
TGGTACAACTC -> GGTACAACTCG
TGGTCATGATG -> GGTCATGATGC
TGGTCCACTCA -> GGTCCACTCAA
TGGTCTGCAGT -> GGTCTGCAGTG
TGGTTGCTAAG -> GGTTGCTAAGC
TGTAAAACGCT -> GTAAAACGCTA
TGTAAGGTTCA -> GTAAGGTTCAA
TGTACAGCGTA -> GTACAGCGTAG
TGTACCCCCGG -> GTACCCCCGGT
TGTACGGATGT -> GTACGGATGTT
TGTACGGTCGT -> GTACGGTCGTG
TGTACGTCTGT -> GTACGTCTGTG
TGTACTTCTTC -> GTACTTCTTCG
TGTAGAACAAC -> GTAGAACAACT
TGTAGAATTCG -> GTAGAATTCGA
TGTAGATATTG -> GTAGATATTGT
TGTAGCAGATC -> GTAGCAGATCT
TGTATGAGCCG -> GTATGAGCCGA
TGTATGGCTGC -> GTATGGCTGCT
TGTATGTAGAA -> GTATGTAGAAT
TGTCAAGTACT -> GTCAAGTACTA
TGTCATGCATT -> GTCATGCATTC
TGTCCACTTGG -> GTCCACTTGGG
TGTCCCCAATA -> GTCCCCAATAG
TGTCGCCACAC -> GTCGCCACACT
TGTCTTCGGAG -> GTCTTCGGAGC
TGTGCACTGAC -> GTGCACTGACT
TGTGCAGGCCG -> GTGCAGGCCGC
TGTGCCGTCCC -> GTGCCGTCCCA
TGTGCCGTCGT -> GTGCCGTCGTA
TGTGGCGAGCA -> GTGGCGAGCAA
TGTGGGACCGA -> GTGGGACCGAA
TGTGGGGCACT -> GTGGGGCACTT
TGTGTACGTCT -> GTGTACGTCTG
TGTGTCCACTT -> GTGTCCACTTG
TGTGTGGGGCA -> GTGTGGGGCAC
TGTTAGCTGTT -> GTTAGCTGTTT
TGTTCTGCTCG -> GTTCTGCTCGT
TGTTGACATTA -> GTTGACATTAC
TGTTGACTGGT -> GTTGACTGGTC
TGTTTACTGCT -> GTTTACTGCTC
TGTTTAGCCCT -> GTTTAGCCCTA
TGTTTCGCAAT -> GTTTCGCAATG
TGTTTGTACGG -> GTTTGTACGGA
TTAACTCTAGG -> TAACTCTAGGC
TTAAGCACCGG -> TAAGCACCGGT
TTAAGCGATAT -> TAAGCGATATA
TTAATATTCGG -> TAATATTCGGA
TTAATCACAGG -> TAATCACAGGA
TTAATGGCAAT -> TAATGGCAATT
TTAATTTCTGG -> TAATTTCTGGG
TTACCGTGACT -> TACCGTGACTC
TTACGTGGAGT -> TACGTGGAGTT
TTACGTGGGCT -> TACGTGGGCTA
TTACTCCACTC -> TACTCCACTCC
TTACTGCGAGC -> TACTGCGAGCG
TTACTGCTCTG -> TACTGCTCTGG
TTACTGTAGAT -> TACTGTAGATA
TTAGAGACAGG -> TAGAGACAGGA
TTAGAGGATAC -> TAGAGGATACG
TTAGAGTTCAC -> TAGAGTTCACA
TTAGCCCTATC -> TAGCCCTATCA
TTAGCTGTTTC -> TAGCTGTTTCG
TTAGGCATGTT -> TAGGCATGTTC
TTAGGTTTATA -> TAGGTTTATAT
TTAGTAGGACA -> TAGTAGGACAT
TTATACTCCAA -> TATACTCCAAC
TTATATCGACG -> TATATCGACGT
TTATCCAAACA -> TATCCAAACAT
TTATTTAATTT -> TATTTAATTTC
TTCAACTCTCC -> TCAACTCTCCT
TTCAATGCTGG -> TCAATGCTGGG
TTCACACTGAT -> TCACACTGATC
TTCACAGGGCA -> TCACAGGGCAG
TTCACGTTGTA -> TCACGTTGTAC
TTCACTGGTTG -> TCACTGGTTGC
TTCACTGTCAA -> TCACTGTCAAG
TTCAGGGTACA -> TCAGGGTACAT
TTCATCCTCGG -> TCATCCTCGGT
TTCATGAGAAA -> TCATGAGAAAA
TTCCCTACATC -> TCCCTACATCG
TTCCCTTCACT -> TCCCTTCACTG
TTCCTTCTTTG -> TCCTTCTTTGA
TTCGAAAGGAT -> TCGAAAGGATA
TTCGACACTTA -> TCGACACTTAC
TTCGCAATGAG -> TCGCAATGAGA
TTCGCAGTCAA -> TCGCAGTCAAT
TTCGGACAGGC -> TCGGACAGGCT
TTCGGAGCTAG -> TCGGAGCTAGG
TTCGGTAACCT -> TCGGTAACCTG
TTCGGTAATCC -> TCGGTAATCCT
TTCGTAGAGAG -> TCGTAGAGAGT
TTCGTCCTATT -> TCGTCCTATTG
TTCGTGAGACC -> TCGTGAGACCT
TTCTAAAAGGA -> TCTAAAAGGAG
TTCTAACATAG -> TCTAACATAGC
TTCTAGGTTAC -> TCTAGGTTACT
TTCTCCCAGAT -> TCTCCCAGATT
TTCTCCGGTTG -> TCTCCGGTTGA
TTCTGACCTTT -> TCTGACCTTTT
TTCTGCTCGTA -> TCTGCTCGTAA
TTCTGGGTATC -> TCTGGGTATCT
TTCTTCGTCCT -> TCTTCGTCCTA
TTCTTGGAGAC -> TCTTGGAGACG
TTCTTTGAAGA -> TCTTTGAAGAC
TTGAAGACCAC -> TGAAGACCACT
TTGACATTACT -> TGACATTACTG
TTGACTGGTCA -> TGACTGGTCAT
TTGAGAATAGG -> TGAGAATAGGG
TTGAGGGGCCT -> TGAGGGGCCTA
TTGATATATTG -> TGATATATTGA
TTGATATGAGA -> TGATATGAGAG
TTGATTGTTTG -> TGATTGTTTGT
TTGCACGTAGT -> TGCACGTAGTT
TTGCATACCGA -> TGCATACCGAG
TTGCCATAGTA -> TGCCATAGTAG
TTGCTAAGCGT -> TGCTAAGCGTG
TTGGAGACGGT -> TGGAGACGGTT
TTGGCAAGGAT -> TGGCAAGGATA
TTGGCGCGGTC -> TGGCGCGGTCT
TTGGCGTAGGC -> TGGCGTAGGCA
TTGGCTACTCG -> TGGCTACTCGT
TTGGGGATGAG -> TGGGGATGAGG
TTGGTACAACT -> TGGTACAACTC
TTGGTCCACTC -> TGGTCCACTCA
TTGTAAGGTTC -> TGTAAGGTTCA
TTGTACCCCCG -> TGTACCCCCGG
TTGTACGGATG -> TGTACGGATGT
TTGTATGAGCC -> TGTATGAGCCG
TTGTATGTAGA -> TGTATGTAGAA
TTGTCGCCACA -> TGTCGCCACAC
TTGTGCCGTCG -> TGTGCCGTCGT
TTGTGTCCACT -> TGTGTCCACTT
TTGTTAGCTGT -> TGTTAGCTGTT
TTGTTTAGCCC -> TGTTTAGCCCT
TTGTTTGTACG -> TGTTTGTACGG
TTTAAGCACCG -> TTAAGCACCGG
TTTAATTTCTG -> TTAATTTCTGG
TTTACTGCTCT -> TTACTGCTCTG
TTTAGCCCTAT -> TTAGCCCTATC
TTTAGGCATGT -> TTAGGCATGTT
TTTATATCGAC -> TTATATCGACG
TTTCATGAGAA -> TTCATGAGAAA
TTTCGAAAGGA -> TTCGAAAGGAT
TTTCGCAATGA -> TTCGCAATGAG
TTTCGGTAACC -> TTCGGTAACCT
TTTCTCCGGTT -> TTCTCCGGTTG
TTTCTGGGTAT -> TTCTGGGTATC
TTTGAAGACCA -> TTGAAGACCAC
TTTGAGAATAG -> TTGAGAATAGG
TTTGATTGTTT -> TTGATTGTTTG
TTTGTACGGAT -> TTGTACGGATG
TTTGTGCCGTC -> TTGTGCCGTCG
TTTTAGGCATG -> TTTAGGCATGT
TTTTCATGAGA -> TTTCATGAGAA
TTTTGTGCCGT -> TTTGTGCCGTC
TTTTTGTGCCG -> TTTTGTGCCGT
TTTTTTGTGCC -> TTTTTGTGCCG
TTTTTTTGTGC -> TTTTTTGTGCC
TTTTTTTTGTG -> TTTTTTTGTGC
